aba	aba
abandonic	abandon
abazie	abazic
abecedar	abeceda
abilitare	abilita
abjudecare	judeca
ablepsie	ablepsie
aboliționistă	aboliționist
abordor	abordaj
abreacție	reacție
abscisă	abscisă
absintină	absintină
absolvent	absolvi
abstenționist	abstență
abstracționism	abstractiza
abur	abur
academie	academie
acantologie	acantologie
acarioză	acarioză
acăriță	acăriță
accentuare	accent
accesare	acces
accidențe	accidențe
acetificare	acetifica
acetonemie	cetonemie
achitare	achita
acidificare	acidifica
acil	acil
aclimatare	climă
acolit	acolit
acompaniere	companie
acord	acord
acordor	acorda
acreditiv	acredita
acrime	acrime
acrocefalie	acrocefal
acromatism	cromat
acroparestezie	acroparestezie
acru	acru
actinodon	actinodon
actinot	actinot
activistă	activa
actriță	act
acționare	acționa
aculeat	aculeu
acuplare	cupla
acustomat	acustomat
acuzație	acuza
acvanaut	acvanaut
acvatintă	acvatintă
acvilon	acvilon
adamită	adamită
adăpătoare	adăpa
addenda	addenda
adenohipofiză	adenohipofiză
aderare	adera
adhocrație	adhocrație
adiere	adia
adjectiv	adjectiv
adjudecător	judeca
administrație	administra
admonestație	admonesta
adolescentă	adolescent
adorator	adora
adresare	adresa
aducție	aducție
adunare	aduna
adversar	advers
aerație	aera
aerobioză	aerobioză
aerodinamician	aerodinamic
aerofilatelist	aerofilatelie
aerogeologie	aerogeolog
aerolog	aerolog
aeromodelism	aeromodel
aeropatie	aeropatie
aerosondaj	aerosondaj
aeroterapie	aeroterapie
aerozină	aerozină
afazic	afazie
afectivism	afectiv
afgan	afgan
afinată	afinată
afișaj	afiș
aflicțiune	aflicțiune
aforisticitate	aforistic
africanistică	africanistic
afrodiziac	afrodiziac
afumătură	afuma
afuziune	fuziona
agată	agată
agendă	agendă
agheasmatar	agheasmatar
agitare	agita
aglosie	aglosie
agneț	agneț
agoniseală	agonisi
agramat	agramat
agrementare	agrementa
agricultură	agricultură
agrișă	agrișă
agroecologie	agroecologie
agrologie	agrologic
agrostologie	agrostologie
agud	agud
aikido	aikido
ajurare	ajura
ajutorare	ajuta
alai	alai
alarmare	alarma
alăturare	alătura
albaspină	albaspină
albedo	albedo
albigenzi	albigenz
albinioară	albină
albit	alb
album	album
alcade	alcade
alcan	alcan
alchimie	alchimie
alcoolmetrie	alcoolmetrie
aldămaș	aldămaș
alegător	alege
alelism	alelism
alergare	alerga
alergoză	alergoză
aleuronat	aleuronă
alezaj	aleză
alfatron	alfatron
algezimetrie	algezimetrie
algologă	algologă
aliaj	alia
alienație	aliena
alimentator	alimenta
alior	alior
alizarină	alizarină
alocație	aloca
alogamie	alogam
alopatie	alopat
alpinariu	alpin
altercație	altercație
althorn	althorn
alto	alto
altruism	altruism
alun	alun
alunele	alună
alunizare	aluniza
alvițar	alviță
amant	amant
amator	amator
amănunțit	amănunt
ambalaj	ambala
ambianță	ambiant
ambivalență	ambivalență
ambră	ambră
ambuscadă	ambusca
amenajare	menaj
amentifere	amentifer
americiu	americiu
ametrop	ametrop
amfibolie	amfibol
amfiox	amfiox
amforofonie	amforofonie
amidază	amidază
amigdalectomie	amigdalectomie
amimie	amimie
aminozaharuri	aminozahar
amnios	amnios
amoniat	amoniat
amoralitate	moral
amortisment	amortisment
ampelografie	ampelograf
ampex	ampex
amplitudine	amplitudine
amprentologie	amprentologie
amuțire	muți
anabolism	anabolism
anacrotism	anacrotic
anafora	anafora
anagnost	anagnost
analecte	analecte
analitism	analic
analogizare	analogiza
anandrie	anandrie
anarhizare	anarhiza
anastaltic	anastaltic
anatocism	anatocism
ancastrament	ancastrament
anchilozare	anchiloza
ancorare	ancora
andezin	andezin
andosator	andosa
androlog	androlog
anecdotă	anecdotă
anemofilie	anemofil
anemotrop	anemotrop
anestezimetru	anestezimetru
aneuroză	aneuroză
anfractuozitate	anfractuos
angelism	angelic
anghinare	anghinare
angiospasm	angiospasm
anglie	glei
anglofobie	anglofob
angrenare	angrena
anilină	anilină
animator	animat
aniset	aniset
anizometropie	izometropie
anonimat	anonim
anosmie	anosmie
ansamblu	ansamblu
antalgic	antal
antecameră	cameră
antedeviz	deviz
antenat	nat
anteră	anteră
antesoclu	soclu
antiamerican	americă
antic	tic
anticataral	catar
anticlimax	climax
anticoncepție	concepție
anticreștinism	creștin
antidetonanță	antidetonanță
antierou	erou
antifon	timf
antigrevist	grevă
antiimperialist	imperial
antiliteratură	literatură
antimălurire	antimălurire
antimoniu	antimonic
antioxigen	oxid
antiparlamentarism	parlamentar
antipod	pod
antirasism	ras
antireumatismal	reumatism
antiscorbutic	scorbut
antisionist	sifon
antitermic	terme
antitrinitar	trinitar
antivomitiv	vomita
antologist	antologa
antracit	antract
antrenare	antren
antretoază	antretoază
antropofilie	antropofil
antropolatru	antropofil
antropomorfizare	antropomorfiza
antropopsihologie	psiholog
anuitate	anuitate
anus	anus
aortografie	ortograf
apartament	apartament
apă	apă
apeductier	apeduct
apelpisit	apelpisie
apersonalizație	apersonalizație
apidă	apidă
aplanare	plan
aplicativitate	aplicativ
apocrif	apocrif
apogenie	apogenie
apologie	apolog
apoplexie	apoplexie
aposteriorism	aposterioric
apoteoză	apoteoză
aprehensiune	prehensiune
aprindere	prinde
aprobativitate	aprobativ
aproximativitate	aproximativ
apucătură	apucătură
ar	ar
arabofon	arab
arahnoidă	arahnoidă
aramaică	aramaică
araucaria	araucaria
arămire	arămi
arbitragist	arbitra
arborescență	arborescență
arcan	arc
arculeț	arculeț
ardență	ardență
arenaria	arenaria
areografie	reograf
arestare	arest
argăție	argăți
argeșeancă	argeșeancă
argint-viu	argint-viu
argonaut	argon
arguție	arguție
arhegoniată	arhegoniată
arheologă	arheologă
arhiepiscop	episcop
arhimicetă	arhimicetă
arhitectură	arhitectură
arhivologie	arhivologie
arhondologie	arhondologie
arie	ar
arimaj	arima
aripioară	aripioară
aristotelizare	aristoteliza
aritmomanie	aritmomanie
armament	arma
armăsar	armă
armie	arm
armonizare	armoniza
arnici	arin
arondare	aronda
arseniat	arsenic
arșiță	arșiță
arteriolă	arteriolă
artificialism	artificial
artistă	artistă
artralgie	artralgic
arțag	arțag
arzător	arz
asambleză	asambleză
ască	ască
asceză	asceză
ascultare	asculta
ascuțitoare	ascuțit
asemie	asemie
asesorat	asesor
asfaltor	asfalt
asiatic	asiat
asigurat	asigura
asindeton	asindet
asiro-babilonian	asiro-babilonian
asociaționism	asociațional
asparagus	asparagus
aspic	spic
aspreală	aspreală
astâmpăr	astâmpăr
astereognozie	stereognozie
astmă	astmă
astringență	stringență
astrofizică	astrofizică
astrograf	astrograf
astrometru	astrometru
astroscop	astroscop
astupuș	astupuș
asurzire	surzi
așteptat	aștepta
ataman	taim
ataxofobie	ataxofobie
atelectazie	atelectazie
atentator	atentat
aterizare	ateriza
atex	tex
atlas	atlas
atmosferizare	atmosferiza
atomizor	atomiza
atractivitate	atractiv
atrium	atrium
ață-de-mare	ață-de-mare
audientă	audientă
audiologie	audiolog
augmentativ	augmenta
aur	aur
auriga	auriga
austenită	austenită
austru	anus
autism	aut
autoalarmă	alarmă
autoaprindere	aprinde
autobiciuire	biciui
autocamionetă	camionetă
autocefalie	autocefal
autocod	cod
autocoră	autocoră
autodeclanșator	declanșa
autodină	dină
autoechilibrare	echilibra
autoexil	exil
autofurgon	fur
autogestiune	gest
autogreder	greder
autoimpunere	impune
autolibrărie	librărie
automatism	automat
automobil	morb
automutilare	mutila
autoorientare	orient
autopornire	porni
autorapid	rapid
autoritarism	autoritar
autoservire	serv
autoșeniletă	șeniletă
autotrailer	trailă
autoturism	tur
autozom	autozom
auzibilitate	auzi
avancronică	cronică
avanscenă	scenă
avă	avă
avere	avere
aviație	aviație
avionetă	avionetă
avocată	avocată
avut	avut
axiomă	axiomă
axonometru	auxonomie
azbucoavnă	azbucoavnă
azoderivat	azoderivat
azotometru	azotometru
azvârlitură	zvârlitură
babă	babă
babit	baba
babuvist	babuvist
bacăul	bacă
baclava	baclava
bacteriemie	bacteriemie
bacteriologie	bacteriolog
baculit	bacăul
bagaj	baga
bahnă	bahnă
baie	ba
bait	ba
baladin	baladă
balamuție	balamuție
balanță	balanță
balauroaică	balauroaică
balcanistică	balcanistică
baleiaj	baleia
balestră	balestră
balistică	balistică
balneofizioterapie	balneofizioterapie
balon-sondă	balon-sondă
balotaj	balot
balustradă	balustradă
banană	banană
banchetă	banchetă
bandaj	bandă
banderolă	banderolă
bandulă	bandulă
banjoist	banjo
baptisteriu	baptisteriu
baracudă	baracudă
barba-împăratului	barba-împăratului
barbă-albastră	barbă-albastră
barbotare	barbota
barcarolă	barcarolă
barem	barem
baricentru	baric
barisferă	barisferă
baroană	baroană
barograf	baroc
baros	bar
barou	barou
basarabeancă	basarabeancă
basculă	basculă
bason	bas
bastonaș	bastonaș
bașcan	bașcă
batalistă	batalistă
batere	bate
batir	batir
batocrom	batocrom
batracocefalie	batracocefalie
bavetă	bavetă
bazedov	bazedov
bazinaș	bazinaș
băbătie	băbătie
băcăuan	băcăuan
bădie	bădie
băieș	băieș
băiețoi	băiețoi
bălăbănit	bălăbăni
băligar	băliga
bălticea	bălti
bănărit	bănărit
bănie	băni
bărbărie	bărbărie
bărbierit	bărbier
bărcar	bărcar
bărzăun	bărzăun
bășină	bășină
bătătorniță	bătătorniță
bătrânime	bătrân
bâjbâială	bâjbâială
bântuire	bântui
bârnă	bârnă
bâzâială	bâzâială
bebi	bebi
bechi	bechi
behaism	bea
bel	bel
beletristică	beletristică
beligeranță	beligeranță
belșug	belșug
benedictin	benedictin
bengali	bengali
bentonit	beton
benzinărie	benzinărie
benzpiren	benzpiren
berbecărie	berbecărie
beri-beri	beri-beri
bernardin	bernardin
berton	berat
beșlic	bel
betejeală	betejeală
betonist	beton
bețivancă	bețivancă
biban	ban
bibiluri	bibi
bibliofilm	bibliofilm
biblioman	biblioman
bibliotehniciană	bibliotehniciană
bicicletă	bicicletă
bicorn	corn
bie	e
bifurcare	bifurca
bigotism	bigot
bijuterie	bijuterie
bildungsroman	bildungsroman
bilion	bil
bimetal	meat
bine	bina
binormală	binormală
biocenologie	cenologie
bioclimatologie	climatolog
biocultură	cultură
bioelectricitate	electric
biofizician	fizic
biogeocenoză	biogeocenoză
biogrupă	grupă
biologist	biolog
biomedicină	medicină
biomotor	moft
biopreparat	prepara
biospeolog	speolog
biotehnologie	tehnolog
biotop	top
biplan	plan
birjar	birjă
birocratizare	birocratiza
biscuit	biscuit
bismut	bis
bisulfură	sulfură
bitumare	bitum
bivoliță	bivoliță
bizantinologă	bizantinologă
blagoman	blagoman
blanchetă	blanchetă
blastoderm	blastoderm
blastulă	blastulă
blăjean	blăjean
blefaroconjunctivită	blefaroconjunctivită
blestemăție	blestemăție
blocaj	bloc
bluming	bluming
boală	boală
bober	bob
bobot	bobot
bocănit	boacăn
bocire	boc
boehmit	boem
bogătaș	bogătaș
boi	boi
boieresc	boier
boit	boit
bold	bold
bolfă	bolfă
bolometrie	bolometric
boltă	boltă
bombardare	bombarda
bombănit	bombăni
bon	bon
bondoc	bondoc
bonitate	bon
bonz	bonz
borax	borax
bordei	bordei
borfășie	borfășie
boroană	boroană
borticică	borticică
boschet	boschet
bostănoasă	bostănoasă
boștină	boștină
botă	botă
botoașă	botoașă
boțișor	boți
boul-lui-Dumnezeu	boul-lui-Dumnezeu
bovidee	bovid
braconaj	bracona
bradilalie	bradilalie
brahianticlinal	brahianticlinal
bramă	bramă
branhie	branhie
brasardă	brasardă
braț	braț
brăbin	brăbin
brădui	brădui
brăzdar	brăzda
brânci	brânci
brânza-iepurelui	brânza-iepurelui
brâuleț	brâuleț
brecie	brec
bretelă	bretelă
brezaie	breza
brichetare	bricheta
brie	brei
brioală	brioală
brișcă	brișcă
brizură	brizură
brodat	borod
bromhidroză	bromhidroză
bronholog	bronhiolă
bronhotomie	bronhotomie
bronzier	bronz
broșare	broșa
brotan	barot
bruiaj	birui
brumăriță	brumăriță
bruș	bruș
bubalină	bubalină
bubuitură	bubuitură
bucătar	bucă
bucefal	bu
buchețel	buche
buciumaș	buciumaș
bucolică	bucolică
bucurie	bucurie
budist	baud
buflei	buflei
bufonerie	bufonerie
buha-verzei	buha-verzei
buiandrug	buiandrug
bujoraș	bujoraș
bulbucătură	bulbucătură
bulevard	bulevard
bulgăr	bulgăr
bulion	bulin
bulvan	bulvan
bumbăcăreasă	bumbăcăreasă
bun-plac	bun-plac
bunceag	bunic
bunic	bun
burat	bur
burduhan	burduhan
bureză	bureză
burgraviat	burgrav
burlan	bur
bursă	bursă
burtăverzime	burtăverzime
busc	busc
bușitură	bușitură
butaforie	butafor
butcă	butcă
butilcauciuc	butilcauciuc
butoiaș	butoiaș
buturuguță	buturuguță
buzoiancă	buzoiancă
cabalist	cabală
cabazlâc	cabazlâc
cablor	cablu
cabraj	cabra
cacao	cacao
cacogeneză	cacogeneză
cadastrare	cadastra
cadiascher	cadiascher
cadră	cadră
cafas	cafas
cofeină	cofeină
cafeu	cafe
caiacistă	caiacistă
caimacam	caimacam
cal-de-mare	cal-de-mare
calamandros	calamandros
calanco	calanco
calcan	calc
calchiere	calchiere
calcină	calcină
calcografie	calcograf
calculație	calculație
calefacție	calefacție
calfă	calfă
caliciu	cal
caligraf	calic
calipso	calipso
calmitate	calm
caloneț	caloneț
calorimetru	calorie
calpuzan	calpuzan
calvados	calvados
camarad	camarad
cambodgian	cambodgian
cambuzier	cambuză
camelotă	camelotă
camerunez	camerunez
camionetă	camionetă
campanie	campanie
campus	campus
canabioză	canabioză
canalie	canal
canastă	canastă
cancelarist	cancelar
cancerologie	cancerolog
candidatură	candidatură
canevas	canevas
canid	canid
canoe	canoe
canonieră	canonieră
cantabile	cantabil
cantată	cantată
canto	canto
cantoră	cantoră
caolinizare	caolinizare
capama	capama
capelatură	capelatură
capilarmetru	capilar
capitație	capitație
capitulare	capitular
caponare	capon
capră-neagră	capră-neagră
capsatoare	capsat
captativitate	captativitate
capucino	capucino
carabăț	carabăț
caracteriogramă	caracteriogramă
caracul	carmac
carambol	carab
carapace	carapace
caravă	caravă
carbodiamidă	carbodiamidă
carbonado	carbonado
carbonizare	carboniza
carburație	carburație
carcinomatoză	carcinomatoză
cardatoare	cardatoare
cardiocel	cardiocel
cardiomalacee	cardiomalacee
cardioscopie	cardioscop
carenată	carenată
carfologie	carfologic
caricaturist	caricatură
carilon	cadril
caritate	car
carmin	car
carnavalizare	carnavaliza
caroserie	caroserie
carpen	carpen
carpotecă	carpotecă
carte	cart
carting	carting
cartofor	cartof
cartometrie	cartometrie
cartotecă	cartotecă
caruselist	carusel
cascadoare	cascadoare
casetotecă	casetotecă
casoletă	casoletă
casting	casting
castronaș	castronaș
cașerare	cașera
cataclază	cataclază
catagrafie	catagrafie
catalizare	cataliza
catamorfism	catamorfism
catari	catari
catatonie	catatonic
catedră	catedră
caterincă	caterincă
catifea	cataif
catoblepas	catoblepas
catoscop	catoscop
cauciuc	cauciuc
caun	caun
cauzalgie	cauzal
cavaler	caval
cavernogramă	cavernogramă
cavitate	cav
cazangerie	cazangerie
cazemată	cazemată
cazuist	caz
căciuloi	căciuloi
căinare	căina
călărime	călărime
călcător	călcător
căldăroi	căldăroi
călinet	călin
călugărie	călugăr
cămăraș	cămăraș
cămătăreasă	cămătăreasă
cănăruț	cănăruț
căpătuire	căpătui
căpicioară	căpicioară
căpiță	căpiță
căpșor	căpuș
căputare	căputa
cărăruică	cărăruică
cărbunar	cărbune
cărnosire	cărnos
cărturar	cătur
cărucior	cruci
căsăpire	căsăpi
căsnicie	căsnicie
cătănioară	cătănioară
cătun	cătun
cățelan	cățel
căutat	căuta
căzătură	căzătură
câmp	câmp
cânepărie	cânepărie
cântăreț	cântăreț
cârâitoare	cârâit
cârciumă	cârciumă
cărdășie	cărdășie
cârligaș	cârligaș
cârmuitoare	cârmuitoare
cârnit	cârn
cârpitură	cârpitură
câștigare	câștig
ceainărie	ceainărie
ceangău	ceangău
cearcăn	cearcăn
ceasornicărie	ceasornicărie
ceaușel	ceauș
cecogramă	cecogramă
cefalografie	cefalograf
ceferist	cefere
celar	cel
celeritat	celeritat
cella	cella
celometru	celom
celuială	celuială
cementită	cementită
cenomanian	cenomanian
centiar	cent
centrafrican	centrafrican
centrifugare	centrifug
centru	cens
cenuroză	cenuroză
cep	cep
ceramist	ceam
cerber	cerb
cercel	cerc
cerci	cerci
cercușor	cerceluș
cerebralizare	cerebraliza
cerezină	cerezină
cerneală	cerneală
cerșetoare	cerșetoare
certificație	certificație
cerumen	cerumen
cescut	cec
ceșcuță	ceșcuță
cetățuie	cetățuie
cetogeneză	cetogeneză
ceylonez	ceylonez
chec	chec
chehailâc	chehailâc
cheiță	cheiță
chelfăneală	chelfăneală
cheltuitor	cheltui
chemosorbție	chemosorbție
chenăruire	chenărui
cheratină	cheratină
cherațiță	cherațiță
chersin	ches
chestură	chestură
chiaburoaică	chiaburoaică
chibz	chibz
chichirez	chichirez
chietism	chit
chiliasm	chiliasm
chilnă	chilnă
chimicale	chimicale
chimiraș	chimiraș
chimval	chim
chineziterapeut	chineziterapie
chinoleină	chinoleină
chintesență	chintesență
ghiorăială	ghiorăială
chiot	chiot
chiriarh	chirie
chiromant	chilom
chist	chist
chiștoc	chiștoc
chitină	chitină
chițibușar	chițibuș
chiulangie	chiulangie
chivernisire	chivernisi
cianat	cian
cianometru	canoe
ciberneticiană	ciberneticiană
cicălire	cicăli
ciclism	ciclu
ciclogeneză	ciclogeneză
ciclon	ciclu
ciclotimic	ciclotimic
cidru	cidru
cigă	cigă
cilindrurie	cilindrurie
cimen	cimen
cimometru	cimometru
cincantin	cincantin
cineanimatoare	cineanimatoare
cinefil	cine
cinematecă	cinematecă
cineraria	cineraria
cinetică	cinetică
cinologă	cinologă
cintezoi	cintezoi
cioarsă	cioarsă
ciobire	ciob
ciocănire	ciocăni
cioclovină	cioclovină
ciocoiaș	ciocoiaș
cioculeț	cioculeț
ciomăgaș	ciomăgaș
cioplire	ciopli
ciorbă	ciorbă
ciorovăire	ciorovăi
ciperacee	ciperacee
circ	circ
circumcizie	circumcizie
circumstanță	stanță
ciripede	ciripede
cirtă	cirtă
cisternă	cisternă
cistoide	cistoide
cișmegiu	cișmegiu
citatomanie	citatoman
citochimie	citochimic
citogeneză	citogeneză
citopoieză	citopoieză
citronadă	citronadă
ciuboțică	ciuboțică
ciucurel	ciuciur
ciuin	chiu
ciumărea	ciumă
ciupitor	ciupit
ciurlan	ciurel
civilie	civil
cizmăreasă	cizmăreasă
cladodiu	cladodiu
clancăt	clancăt
clapotaj	capot
clasare	clasa
clasificație	clasificație
claustrofobie	claustrofob
clavetă	clavetă
claxon	claxon
clăditor	clădit
clănțănit	clănțăni
clean	cale
clempușor	clempuș
clersă	clersă
clevetitor	cleveti
climat	climă
climatologie	climatolog
clincherizare	clincherizare
clinologie	clinologie
cliping	cliping
clironom	clironom
ciclită	ciclită
clocaj	clonc
clonaj	clon
clonț	clonț
cloramină	cloramină
clorizare	clorizare
clorometrie	clorometric
clorură	clorură
clu	clu
clupă	clupă
coabitare	coabita
coacționar	acționa
coada-rândunicii	coada-rândunicii
coafă	coafă
coagulogramă	coagulogramă
coarbă	coarbă
coate-goale	coate-goale
cobaltină	cobaltină
cobol	bol
cobză	cobză
cocainomanie	cocainoman
cocean	coc
cocioc	cioc
cocon	c
cocoș-de-munte	cocoș-de-munte
cocreditor	credit
cocuță	cocuță
codănel	codănel
codeinomanie	codeinomanie
codire	cod
codobelc	codobelc
coechipieră	echipieră
coeror	cer
cofetar	cofret
cogestiune	gest
coi	i
coit	coit
cojocel	cojoc
colac	lac
colatitudine	lat
colbertism	colet
colecistografie	colecistografie
colectivitate	colectiv
colecționism	colecționa
coleire	coleire
coleric	colier
colibaciloză	colibaciloză
colimare	colima
colindător	colindă
colivioară	colivioară
colobomă	colobomă
colodionare	colodiona
colonat	colon
colonist	colon
coloratură	coloratură
colos	col
colposcopie	colposcop
colțuleț	colțuleț
columbian	columbit
columbotecă	columbotecă
comandant	mandant
comandor	comandă
combainistă	combainistă
combinatorie	combinator
combustibilitate	combustibil
comemorare	memora
comeraj	comerț
comeseană	meseană
comină	mină
comisoaie	comisoaie
comițial	comițiu
comor	mor
compactibilitate	compact
comparatism	comparat
compartimentaj	compartiment
compendiator	compendia
competitivitate	competitiv
complementarism	complementar
complexare	complex
complimentare	compliment
componență	componență
compostare	compost
compoziție	compoziție
compresorist	compresor
compunere	compune
computist	comput
comunicare	comunica
comutabilitate	muta
conăcar	conăci
concentrare	centra
conceptism	concept
concertină	concertină
concesivitate	concesiv
conchistă	conchistă
concitație	citație
concordat	cord
concretitate	concret
concurență	concurență
condeier	condei
condicăreasă	condicăreasă
condominiu	condominiu
condroid	condroid
conductivitate	conductiv
conectică	conectică
confecție	confecție
confesionalism	confesional
confiență	confiență
confiserie	confiserie
conformator	format
confrerie	confrerie
confuzionist	fuziona
congestie	congestie
conglutinare	conglutina
congresist	congres
conimetru	conimetru
conjunctivită	conjunctivită
conlocuire	locui
conorășeană	orășeană
consătean	sătean
consemn	semn
conservă	servă
consignație	consignație
consistoriu	consista
consomme	consomme
conspirație	conspirație
constelație	constelație
constituționalist	constituțional
constructivitate	constructiv
consultant	consult
consumpție	consumpție
contactare	contact
contaminație	contaminație
contemplativitate	contemplativ
contesă	contesă
continentalitate	continental
contondență	contondență
contraanchetă	anchetă
contrabasistă	contrabasistă
contracronometru	clironomie
contracție	contracție
contraextensie	contraextensie
contrainformație	informație
contramină	mină
contrapiuliță	piuliță
contrapunct	punct
contrariu	contrar
contrasubiect	subiect
contratură	tură
contribuabilă	contribuabilă
contubernalitate	contubernal
conținutism	conținut
conveniență	conveniență
convertibilitate	converti
convertor	converti
convoiaj	voi
cooperare	opera
cooptare	optar
copaie	copai
copastie	copastie
copertare	coperta
copilandru	copil
copitat	copiat
coporâie	coporâie
coprologie	coprologic
copt	copt
coral	ral
corăbiele	corăbiele
corbuleț	corbuleț
cordaj	cord
cordialitate	cordial
coreclamantă	reclamantă
corecție	corecție
coregizor	regiza
corelație	relație
coreț	coreț
coriamb	coriamb
corijare	corija
coriză	coriză
cornaci	cornaci
corner	corn
corniță	corniță
coroană	coroană
coroidită	coroidită
coroniță	coroniță
corotip	corotip
corpuscul	corpus
cortel	cort
cortil	cort
corupător	crupă
cosar	cocs
cosie	cosi
cositură	cositură
cosmiatrie	cosmiatrie
cosmofotogrammetrie	cosmofotogrammetrie
cosmonaut	cosmonaut
cosmoviziune	cosmoviziune
costișă	costișă
costumier	costum
coșciug	coșciug
coșniță	coșniță
cotație	cotație
cotei	tei
cotidianitate	cotidian
cotiș	cotiș
cotoc	toc
cotoșman	cotoșman
cotutoare	tutoare
covali	covali
covățică	covățică
covrigar	covrig
coz	coz
cracaj	crac
craidon	caid
craniat	craniu
craniostat	craniostat
crată	crată
craulist	craul
crăcușor	crăcușor
crăpăturică	crăpăturică
crâmpoșie	crâmpoșie
crâșmuță	crâșmuță
creatinină	creatinină
credent	credo
credulitate	credul
creițar	creț
cremometru	cremometru
crenguliță	crenguliță
creofagie	creofag
crepon	crep
crestătură	crestătură
creștinism	creștin
crețișoară	crețișoară
crezol	crez
crijmă	crijmă
criminolog	criminolog
crinieră	crinieră
criofită	criofită
criopatie	criopatie
cripalcă	cripalcă
criptolog	criptolog
crisografie	crisograf
cristalinitate	cristalin
cristalografie	cristalograf
cristelniță	cristelniță
criticism	critic
croazea	croază
croi	croi
cromat	crom
cromatografie	cromatograf
cromleh	cromleh
cromolitografie	cromolitografic
cromotipie	cromotipie
cronică	cronică
cronogramă	cronogramă
cronopatologie	patolog
croșă	croșă
crov	crov
crucificare	crucifica
crug	crug
cruponare	crupon
cruzie	cruzie
cuantificare	cuantifica
cub	cub
cubist	cub
cucernicie	cucernic
cuculide	cuculide
cucută-de-pădure	cucută-de-pădure
cufundare	cufundar
cuib	cuib
cuișoare	cuișoare
culă	culă
culegătoare	culegătoare
culisare	culisa
culmiță	culmiță
cult	cult
culturalitate	cultural
cumacee	cumacee
cumetriță	cumetriță
cumpănă	cumpănă
cumul	cum
cunctator	cunctator
cunună	cunună
cupelă	cupelă
cuplător	cuplă
cupon	crup
cuptor	cupit
curantă	curantă
curățătorie	curățătorie
curbură	curbură
curechi	curechi
curie	cur
curm	curm
cursant	curs
curtare	curta
curtină	curtină
cuscrenie	cuscrenie
cusur	cusur
cușetă	cușetă
cutezare	cuteza
cutreierat	cutreier
cuțovlah	cuțovlah
cuvântare	cuvânt
cuzism	cuzism
cvadrimotor	moft
cuartadecimă	cuartadecimă
cvintet	cvintă
dacism	dac
dactil	dacit
dactilografiere	dactilografie
dadaism	dada
daiaci	daiaci
dalai-lama	dalai-lama
daltonian	dalton
dambla	dambla
danaidă	danaidă
danie	dan
dantism	duant
darac	darac
dat	dat
daumen	daumen
dăltuire	dăltui
dănțuire	dănțui
dărăcitură	dărăcitură
dăruire	dărui
dăscălitură	dăscălitură
dâmbușor	dâmbușor
dârmon	dârmon
dealcoolizare	alcooliza
debarcare	debarca
debitator	debita
deboșat	deboșă
deburbare	deburba
decadentism	decadent
decalc	calc
decalog	decalc
decapaj	paj
decapsulare	capsular
decasilab	decasilab
decălire	căli
decembrist	decembrie
decernare	decerna
decilitru	decil
decineper	decineper
declanșator	declanșa
declin	clin
declorurare	clorura
decodificator	codifica
decolmatare	colmata
decomplexare	complex
deconexiune	conex
decontaminare	contamina
decorație	decorație
decrementare	decrement
decriptor	decripta
decupare	decupa
decurion	curie
dedentiție	dentiție
dedițel-de-mare	dedițel-de-mare
defalcare	defalca
defecare	defeca
defectoscopie	defectoscop
deferire	feri
defibrator	defibra
definitivat	definitiv
defloculare	flocul
deformabilitate	deforma
defrișoare	defrișoare
degazolinare	degazolina
degetar	deget
degivrare	degivra
degrade	degrade
degrosaj	degrosaj
dehidrogenare	hidrogen
dejecție	dejecție
delabializare	labializa
delăsare	lăsa
delestare	lest
delfinologie	delfinolog
deligație	deligație
deliricizare	liriciza
deltanaut	deltanaut
demachiaj	machia
demarare	demara
demâncat	mânca
demineralizare	mineraliza
demitizare	mitiza
demobilizare	mobiliza
demograf	graf
demonism	mono
demonstrabilitate	demonstra
demoralizator	moraliza
demulgator	demula
denaturare	denatura
dendrocronologie	dendrocronologie
denegare	neg
denitrificare	nitrifica
densigramă	densigramă
dentist	dentist
denunțare	denunț
deontologism	deontologic
departajare	departaja
depărtător	depărtător
depesaj	depesaj
deplasament	plasa
depolarizare	polariza
deport	port
depoziție	poziție
depresare	presa
deprogramare	program
depurativ	depura
derapaj	derapa
derea	derea
derivatoare	derivat
dermatalgie	dermatalgie
dermatom	dermatom
dermografie	dermografie
derulare	rula
desablaj	sable
desăgăriță	desăgăriță
descălecare	descăleca
descărnare	descărna
descendent	desen
deschizătură	deschizătură
descojitor	coji
descoperitor	descoperi
descrucișare	descrucișa
desenat	sen
deservire	serv
desfăt	făt
desfrâu	frâu
deshumare	deshuma
desinență	desinență
desmotropie	desmotropie
despădurire	despăduri
despecetluire	pecetlui
despletire	despleti
despreunare	despreuna
destinare	destin
destrămare	destrăma
desțelenire	desțeleni
deszăvorâre	zăvorâre
deșertificare	deșertificare
detailist	dental
detatuaj	tatu
detențiune	detențiune
detersiune	detersiune
detractare	tract
detunare	detuna
deținută	ținută
devascularizare	vasculariza
deversare	deversa
deviometru	deviometru
devlet	devlă
devoțiune	devoțiune
dezabie	dezabie
dezagregator	dezagrega
dezanamorfoză	anamorfoză
dezarticulație	articulație
dezbărare	dezbăra
dezechipare	echipa
dezghiocat	dezghioca
deziderabilitate	deziderabilitate
dezinfectare	infect
dezintegrator	integrat
dezlânare	dezlâna
dezmierdare	dezmierda
deznădejde	nădejde
dezomogenizare	omogeniza
dezrădăcinare	dezrădăcina
dezvelire	dezveli
diabolism	diabolo
diacustică	acustică
diafanoscopie	diafanoscop
diafragmare	diafragma
diagraf	graf
dialectizare	dialectiza
dialog	diac
diamonfos	diamonfos
diaproiecție	proiecție
diastază	stază
diatomit	diatomee
diazoscopie	diazoscopie
dibuială	dibuială
diclorbenzen	diclorbenzen
dicteu	dicta
didactogenie	didactogenie
dietanolamină	dietanolamină
diferențial	diferenția
difterie	difteric
difuziune	fuziune
digestie	digest
digitizor	digitizor
diiamb	iamb
dilacerare	lacera
dilațiune	dilațiune
diluare	lua
dimerlie	dimerlie
dinametru	dinam
dinamologie	dinamologie
dineu	din
dinte	dinte
diolefină	olefină
diorism	dihor
diploe	diploe
diplopie	diplopie
dipsacee	dipsacee
direclie	direclie
direcționalitate	direcțional
dirijism	dirija
discernere	cerne
discofil	disco
discordanță	discordanță
discriminare	discrimina
discurs	curs
disensiune	disensiune
disgrafie	graf
disimulare	simula
dislalie	dislalie
disociabilitate	sociabil
dispașă	pașă
dispersare	dispers
dispoziție	poziție
disritmicitate	ritmic
distil	st
distom	tom
distribuire	distribui
distrugere	distruge
diurnist	diurn
diversionist	diversionism
divinizare	diviniza
divorț	divorț
dixtuor	dixtuor
doagă	doagă
doborâre	doborâre
docilitate	docil
doctorat	doctor
documentalist	documental
dodecaedru	dodecaedru
doftorit	doftori
dogmatician	dogmatic
doi-dinți	doi-dinți
dojană	dojană
doljean	dol
dolorist	dolor
dominație	dominație
domniță	domniță
donator	dona
donjuanism	donjuan
dor	dor
dormitor	dormit
dorsalgie	dorsal
dotare	dota
doxometrie	doxometrie
dracilă	dracilă
draglinistă	draglinistă
drahmă	drahmă
dramatism	dramatic
draperie	draperie
drăcușor	drăcușor
drămuire	drămui
dren	dren
dreptunghi	dreptunghi
driada	driada
dril	dril
drob	drob
droghistă	droghistă
dropică	dropică
drosofilă	drosofilă
druguleț	druguleț
drumeție	drumeț
drușcă	drușcă
dubă	dubă
dublet	dublă
ducă	ducă
dud	dud
duecento	duecento
duh	duh
dulău	dulău
duluță	duluță
duminecea	duminecea
dunăre	dună
duo	duo
după-masă	după-masă
durabilitate	dura
dură	dură
durificare	durifica
duroplast	duopol
dusina	dusina
dușumea	dușumea
ebenisterie	ebenisterie
ebraism	ebraism
ebulioscop	ebulioscop
ecart	cart
echigravitație	gravitație
echilibru	echilibru
echipament	echipa
echistică	echistică
eclat	eclat
eclipsă	eclipsă
ecluziune	ecluziune
ecolalie	ecolalie
ecometru	ecometru
economist	econom
ecosistem	ecosistem
ecranizare	ecraniza
ectoendoparazit	ectoendoparazit
ecu	cu
ecuson	ecu
edec	dec
edict	edict
editor	edict
educator	educa
efectivism	efectiv
efemerotecă	efemerotecă
efigie	efigie
eforat	efor
egalitarism	egalitar
egipteană	egipteană
egofilie	egofil
egrenat	egrena
eicosan	eicosan
ejecție	ejecție
elascop	elascop
elastometrie	elastometrie
electivitate	electiv
electrizare	electriza
electrobeton	electrobeton
electrocarist	electrocar
electrocinetică	electrocinetică
electrod	electrod
electroencefalogramă	electroencefalogramă
electrofotografie	electrofotografie
electrolizor	electroliză
electrometalurgie	electrometalurgie
electronavigație	electronavigație
electronomicroscopie	electronomicroscopie
electroradiolog	electroradiolog
electrostivuitor	electrostivuitor
electrotipie	electrotipic
electuar	electrum
elenistă	elenistă
elevație	elevație
elicopterist	elicopter
eliport	eliport
eliziune	eliziune
eluant	eluant
eluviune	eluviune
emailor	email
emasculator	emascula
embol	bol
emendanda	emendanda
emfază	fază
eminescianism	eminescian
emitanță	emitanță
emondație	emondație
empireu	empire
emul	mul
enalagă	enalagă
encarpă	encarpă
encefalopatie	encefalopatie
encliză	encliză
endemism	edem
endocrinie	endocrin
endofagie	endofag
endomorfism	endomorf
endoteliu	endoteliu
energetician	energetic
engastrimit	engastrimit
engraulide	engraulide
enolizare	enolizare
enorie	nor
enterectazie	enterectazie
enterografie	graf
entomofaună	faună
entomostraceu	entomostraceu
enucleare	enuclea
eoantrop	eoantrop
eozofobie	eozofobie
epanșament	epanșament
epicard	c
epicraniu	coran
epidemiologie	epidemiolog
epifenomenalism	fenomenal
epigeneză	geneză
epigramă	epigramă
epinefrină	epinefrină
episilogism	sinolog
epistolă	stolă
epiteliom	epiteliom
epizonă	zonă
eponim	eponj
epulon	epulon
erbicidare	erbicid
eredobiologie	eredobiologie
eretism	erect
ergogeneză	ergogeneză
ergopsihiatrie	ergopsihiatrie
ergotropie	ergotropie
eritem	eritem
eritropatie	eritropatie
ermitaj	eremit
eroizare	eroiza
erotologă	erotologă
erpetologie	erpetolog
escadrilă	escadrilă
escapadă	escapadă
eschivare	eschiva
escrocherie	escrocherie
esență	esență
esofag	fag
esperanto	esperanto
esterificare	esterifica
estezie	estezie
estivație	estivație
estrogen	estriol
eșafodaj	eșafod
eșarfă	eșarfă
etalajist	etalaj
etalonor	etalon
etapă	tapă
eterie	eter
heterodoxie	heterodox
eteronomie	eteronom
etil	etil
etimologism	etimolog
etirare	etira
etnobotanică	etnobotanică
etnogeneză	etnogeneză
etnoistorie	etnoistorie
etnomuzicologie	etnomuzicolog
etocrat	etos
etravă	etravă
etuvă	etuvă
eudiometrie	eudiometric
euforbiacee	euforbiacee
euhemerism	euhemerism
euploid	euploid
eurodeviz	deviz
europocentrism	europocentrism
eutimie	timid
evaluator	valuator
evaporare	evapora
evazare	evaza
eventrație	eventrație
evirație	evirație
evolută	volută
ex-campioană	ex-campioană
exalare	exala
exarhat	exarh
excentrare	excentra
excipient	excipient
exclamare	exclama
excorporație	excorporație
executare	executa
exequatur	exequatur
exhaustiune	exhaustiune
exigibilitate	exigibil
existențialitate	existențial
exoemisie	exoemisie
exorbitanță	exorbitanță
exostoză	exostoză
expectanță	expectanță
experiență	experiență
expiație	expiație
exploatare	exploata
explozibil	explozie
exponent	expo
expozeu	expo
expropriat	expropria
expurgație	expurgație
exsudație	exsudație
extensogramă	extensogramă
exterminator	extermina
extincție	extincție
extract	extract
extraneitate	extraneitate
extraversiune	vers
extrudare	extruda
exultare	exulta
fabian	fai
fabulație	fabulație
facilitare	facilita
factitiv	factitiv
factură	factură
fagacee	fagacee
fai	fai
falangă	falangă
falarică	falarică
falern	falern
falsificare	falsifica
familiarist	familiar
fanaragiu	fanar
fandosire	fandosi
fanfaron	fanfară
fantasmă	fantasmă
fapt	fapt
fard	fard
farfuriuță	farfuriuță
farinotom	farinotom
farmacofobie	farmacofobie
farmacovigilență	farmacovigilență
fart	fart
fascism	flasc
fasonat	fason
fatalist	fatal
fațetă	fațetă
faustbal	faustbal
fazan	fază
făcăluire	făcălui
făgaș	făgaș
fălcariță	fălcariță
fălțuitor	fălțuit
fărâmat	fărâmă
făt-frumos	făt-frumos
fățuială	fățuială
făuritor	făuri
fânoasă	fânoasă
fârtăție	fârtăție
fâșâire	fâșâi
feblețe	feblețe
fecioraș	fecioraș
fecundat	fecund
federvais	federvais
feldspat	feldspat
felid	felid
felonie	felon
femur	femur
fenil	fen
fenogenetică	fenogenetică
fenomenalism	fenomenal
ferat	ferm
ferecat	fereca
ferfeniță	ferfeniță
ferimagnetism	ferimagnetic
fermenea	ferment
fermentogramă	fermentogramă
ferocitate	ferocitate
ferpar	ferpar
festă	festă
feștelire	feșteli
fetișcană	fetișcană
feudal	feudă
fiasco	fiasco
fibroadenom	fibroadenom
fibroscop	fibroscop
fictivitate	fictiv
fideiusiune	fideiusiune
fierărie	fierărie
fiestă	fiestă
fijian	fijian
filantropinism	filantropic
filat	filă
filer	filă
filicologie	filicologie
filioque	filioque
filmograf	film
filodormă	filodormă
filon	filă
filozof	filozof
filumenie	filumenie
finanțare	finanța
finisoare	finisoare
fiord	fiord
firicică	firicică
firnis	firnis
fisiune	fisiune
fișcă	fișcă
fitocenologie	cenologie
fitogeneză	geneză
fitologă	fitologă
fitotehnie	fitotehnic
fiuleț	fiuleț
fizic	friz
fiziograf	fiziograf
fizionomie	fizionomic
flabel	flabel
flaier	flan
flan	flan
flanșă	flanșă
flautistă	flautistă
flăcăruie	flăcăruie
fleașcă	fleașcă
flecărie	flecări
fleșă	fleșă
flexografie	flexografie
flintuliță	flintuliță
floarea-doamnei	floarea-doamnei
floculație	floculație
florentin	florentin
floricultură	floricultură
flotare	flota
fludor	fludă
fluieraș	fluieraș
fluoresceină	fluoresceină
fluoroză	fluoroză
fluture-alb	fluture-alb
foac	foac
foc	foc
focșăneancă	focșăneancă
foileton	foileta
folclor	folclor
foliculină	foliculină
folosință	folosință
fondator	fonda
fonetistă	fonetistă
fonoghid	fonoghid
fonometru	fonometru
fontură	fontură
forceps	forceps
forfotă	forfotă
formaj	formă
format	formă
formiat	formic
fornicator	fornicator
forțaj	forță
fosfatare	fosfat
fosforism	fosfor
foșnit	foșni
fotocartare	fotocartare
fotoconducție	fotoconducție
fotocronograf	fotocronograf
fotoelement	fotoelement
fotograf	foton
fotogravură	fotogravură
fotometrie	fotometric
fotonastie	fotonastie
fotosculptură	fotosculptură
fototelegraf	fototelefon
fourierism	furier
fracționism	fracționa
fragmentație	fragmentație
franceză	franceză
francofobie	francofob
franțuzire	franțuz
frasnian	frasin
frază	frază
frăguță	frăguță
frățâne	frățâne
frâncușă	frâncușă
frâuleț	frâuleț
frecventare	frecvent
frenezie	frenezie
fretare	freta
friabilitate	friabil
friganea	frigana
frigorifer	frigorie
fripta	fripta
friz	friz
frondă	frondă
frotir	frotir
fructoză	fructoză
frunzar	frunză
frunzișoară	frunzișoară
ftalat	fatal
vtori-stolnic	vtori-stolnic
fugaci	fugaci
fuguță	fuguță
fulg	fulg
fulgurit	fulguire
fumat	fum
fumegărie	fumegărie
funcție	funcție
fund	fund
fundătură	fundătură
funicular	funicul
furajor	furaj
furchet	furchet
furie	fur
furnicătură	furnicătură
furt	furt
fusarolă	fusarolă
fuște	fuște
fuzel	fuzel
fuzit	fuzit
gabionaj	gabion
gadoliniu	gadoliniu
gagist	gag
gaibarace	gaibarace
galactofag	galactoză
galantină	galantină
galbulă	galbulă
galerie	galerie
galiformă	galiformă
galiu	gal
galopadă	galopadă
galvanocauterizare	galvanocauterizare
galvanotehnică	galvanotehnică
gamaterapie	gamaterapie
gametofor	gametofit
gangă	gangă
garaj	gară
gară	gară
gardină	gardină
garmond	garmond
garou	garou
gastroenterolog	gastroenterolog
gastronom	gastronom
gastrulă	gastrulă
gatofobie	gatofobie
gavotă	gavotă
gazetăraș	gazetăraș
gazogenerator	gazogenerator
găbjire	găbji
găină-de-mare	găină-de-mare
găinușă-de-seară	găinușă-de-seară
gălățean	gălățean
gălbior	gălbiu
găoază	găoază
găsit	găsi
găurea	găuri
găzduire	găzdui
gâgâire	gâgâi
gâlgâire	gâlgâi
gândirism	gândire
gângurire	gânguri
gârlișoară	gârlișoară
gâscăriță	gâscăriță
gâtuitor	gâtui
geam	geam
geamgiu	geam
gebea	gheb
gelinită	gelinită
gemă	gemă
genă	genă
general-maior	general-maior
generator	genera
geneziologie	geneziologie
genol	gen
genuinitate	genuin
geobotanistă	geobotanistă
geodeză	geodeză
geofizică	geofizică
geograf	geograf
geologie	geolog
geometrism	geometră
geonomie	geonomic
geotactism	geotactism
gepid	gepid
gerare	gerar
germanist	german
germănar	germănar
gerontocrată	crată
geruială	geruială
gestapovistă	gestapovistă
getinax	getinax
gheboșat	gheboșa
ghemuire	ghemui
gherghin	gherghef
ghermesut	ghermesut
ghețărie	ghețărie
ghicit	ghioc
ghidropă	ghidropă
ghilit	ghiol
ghimpe-pădureț	ghimpe-pădureț
ghintuire	ghintui
ghiocel	ghioc
ghiontit	ghiont
ghiozdan	ghizd
ghismană	ghismană
ghizd	ghizd
gig	gig
gigantomanie	gigantomanie
gimcanist	gimcană
gimnofobie	gimnofob
ginecofobie	ginecofobie
ginerie	gineri
ginopară	ginopară
gir	gir
giravion	giravion
giromanție	giromanție
girovag	girovag
giumbușluc	giumbușluc
glacialitate	glacial
glacizare	glacizare
glandulă	glandulă
glasvand	glasvand
glăsuire	glăsui
gleznișoară	gleznișoară
glicometrie	glicometrie
gliptal	gliptal
glisare	glisa
globalizare	globaliza
glodărie	glodărie
glosar	gelos
glosograf	glosograf
glucidă	glucidă
glumelă	glumelă
gnoseolog	gnoseolog
goarnă	goarnă
godin	glod
gog	gog
gogoșărie	gogoșărie
golănime	golănime
goliște	goliște
gonaș	gonaș
gonidie	gonidie
gonitor	goni
gornic	gorun
gospodărire	gospodări
goz	goz
gradier	grad
grafie	graf
grafologie	grafolog
graham	graham
gramatician	gramatic
granat	grant
grangur	grangur
granulație	granulație
grapină	grapină
gratinare	gratina
gravelă	gravelă
gravor	grav
grădinuță	grădinuță
grămăticie	grămătic
grăunță	grăunță
greblare	grebla
greco-roman	greco-roman
grefă	grefă
greisen	greisen
gresie	gresie
grifaj	grifă
grimare	grima
grindei	grindei
griș	griș
groapă	groapă
grohăitură	grohăitură
gropiță	gropiță
grosular	grosular
gruie	grui
grupare	grup
guano	guano
gudronator	gudrona
gulag	gulag
gumilastic	gumilastic
guraliv	guraliv
gurluire	gurlui
gustare	gustar
gușter	gușat
gutuie	gutui
guvernatorat	guvernator
habar	habar
habronemoză	habronemoză
hagealâc	hagealâc
haidău	haidău
haită	haită
halca	halca
half	half
halografie	halo
halterofilie	halterofil
hamalâc	hamalâc
hanat	han
hangar	hang
hanță	hanță
haplologie	haplologie
harabaie	haraba
harbuzărie	harbuzărie
harhăt	harhăt
harpon	harpă
hasidism	hasidism
hașură	hașură
hațegancă	hațegancă
haveză	haveză
hăci	hăci
hăire	hă
hămăitură	hămăitură
hărțuială	hărțuială
hăulire	hăuli
hârâitoare	hârâit
hârjoană	hârjoană
hârtău	hârtău
heautoscopie	heautoscopic
hectar	hec
hedonistică	hedonistică
helcometru	helcometru
heliocentrală	centrală
heliogravor	grav
heliostat	st
heliu	u
hemangiom	hemangiom
hematocrit	hematocrit
hematologie	hematolog
hematurie	hematuric
hemicranie	hemicranie
hemobiologă	biologă
hemogenie	hemogenie
hemoprofilaxie	profilaxie
hemostază	stază
henri	henri
hepatolog	hepatolog
heptan	heptan
herme	herme
heroinomanie	heroinoman
hessian	hessian
heterofite	heterofite
heteropode	heteropode
heterotrofie	trofic
hexaedru	hexaedru
hexastil	st
hialografie	hialograf
hibridație	hibridație
hidatidă	hidatidă
hidrant	hidră
hidrazidă	hidrazidă
hidroameliorare	ameliora
hidrobiologă	biologă
hidroceluloză	celuloză
hidrocoră	hidrocoră
hidrofaună	faună
hidroftalmie	hidroftalmic
hidrogeolog	genol
hidroizolare	izola
hidromanie	mani
hidrometru	metru
hidropedeză	hidropedeză
hidroseparator	separa
hidrotehniciană	tehniciană
hienă	hienă
hifă	hifă
higroscopie	higroscop
himenologie	himenologie
hinterland	hinterland
hiperbată	bată
hipercorectitudine	corect
hiperimunizare	imuniza
hipermnezie	hipermnezie
hipersecreție	secreție
hipertiroidie	hipertiroidie
hipiatru	hipic
hipnotizator	hipnotiza
hipocalcie	hipocalcie
hipocotil	cot
hipofizare	hipofizar
hipogrif	hipogrif
hipomobil	morb
hipostază	stază
hipotonie	hipotonic
hipsometrie	hipsometric
hirudineu	hirudineu
hispanofil	hispanofil
histoautoradiografie	histoautoradiografie
histomonoză	histomonoză
hitlerism	hitlerism
hoardă	hoardă
hocheist	hochei
hodorogeală	hodorogeală
hoitar	hoit
horilcă	horilcă
holocefal	holocefal
holoparazit	para
homeopată	pată
hominid	hominid
homogrefă	grefă
homunculus	homunculus
hoplomahie	hoplomahie
horeț	horeț
hormonologie	hormonologie
horotermă	horotermă
hostie	hostie
hoție	hoț
hrana-vacii	hrana-vacii
hrisov	hrisov
hublou	hublou
hughenot	hughenot
huligan	huli
hulubiță	hulubiță
hunedorean	hunedorean
hurican	hipuric
husar	husă
huțan	huța
iacă	iacă
iahting	iahting
iarba-acului	iarba-acului
iarba-osului	iarba-osului
iarbă-neagră	iarbă-neagră
iatagan	iatagan
iaurt	iaurt
ibovnicel	ibovnic
ichilic	ichi
iconicitate	conic
iconolatră	iconolatră
iconostrof	iconostrof
ictus	ictus
identație	identație
ideologă	ideologă
idioecologie	idioecologie
idiosincrasie	idiosincrasie
ido	do
ied	ied
ienicerime	ienicer
iepuroaică	iepuroaică
ierbărit	ierbărie
ierodiacon	ierodiacon
ieșind	ieșind
iezuit	iezuit
iglu	iglu
ignorantism	ignorant
ihtiofaună	ihtiofaună
ihtiopatologie	ihtiopatolog
ilău	ilău
ileus	ileus
ilizibilitate	lizibil
iluminist	lumină
iluviune	iluviune
imagine	imagine
imanentism	imanent
imbecil	imbecil
imediatitate	imediat
iminei	minei
imnografă	imnografă
imolație	imolație
impactare	impact
impediment	pediman
imperforație	perforație
impersonalitate	personal
implacabilitate	implacabil
implozie	implozie
importațiune	importațiune
impozabilitate	impozabil
impregnol	impregna
impressum	impressum
impromptu	impromptu
impudoare	pud
impur	pur
imunizare	imuniza
imunologă	imunologă
in	in
inadaptabilitate	adapta
inamic	amic
inariță	inariță
incantație	incantație
incendiatoare	incendiatoare
inchiziție	inchiziție
incitare	cit
inclinometrie	inclinometrie
incombustibilitate	combustibil
inconformism	conform
inconvenient	conveni
incredibilitate	credibil
incubator	cuba
incurie	cur
indelicatețe	delicatețe
indeterminist	determina
indicanurie	indicanurie
indigen	indic
indisciplină	disciplină
individă	individă
indoeuropenism	indo-european
indolog	indol
inductotermie	inductotermie
industrie	industrie
inelaj	inel
inervare	inerva
inexpugnabilitate	inexpugnabil
infarct	infarct
infern	infern
infinitism	finit
inflamare	inflama
informare	formar
infracționalitate	infracțional
infuzor	infuz
ingrat	ingrat
inhibiție	inhibiție
inimoi	inimoi
inițiat	ioniți
injustiție	justiție
inovator	nova
inscripție	inscripție
insecutor	insecutor
insinuare	insinua
insomnie	somn
inspirator	inspirat
instanță	stanță
instinct	instinct
instructoare	instructoare
instrumentație	instrumentație
insularism	insular
insurgență	insurgență
integralist	integral
integument	tegument
intemperie	intemperie
intentare	intenta
intercalație	intercalație
intercondiționare	condiționa
interesare	interes
interfon	fon
interlocutor	locui
intermodulație	modulație
internod	nod
interpelație	interpelație
interpretațiune	interpretațiune
interscapulum	interscapulum
intertext	text
intervertire	interverti
intimat	intim
intoxicare	intoxica
intravilan	intravilan
introspecție	introspecție
inulină	inulină
invariabilitate	varia
inventator	inventa
invertază	invertază
invidiere	invidie
invocator	invoca
iobăgiță	iobăgiță
iodopsină	iodopsină
ioniți	ioniți
iordan	iod
ipingea	paing
ipotecare	ipotecar
irani	irani
iraționalitate	rațional
iregularitate	regular
iresponsabilitate	responsabil
iridoscop	iridoscop
irită	irită
ironie	ironic
irupție	irupție
iscodeală	iscodeală
islamism	islam
isop	isop
isprăvire	isprăvi
isteție	isteț
istorist	istoric
italian	tal
iterație	iterație
iubițel	iubi
iugoslav	iugoslav
iușcă	iușcă
ivorin	izvor
izbeliște	izbeliște
izmă	izmă
izobată	bată
izogamie	izogam
izolaționist	izolaționism
izonefă	izonefă
izopren	izopren
izotipie	tip
izvoditor	izvodi
îmbătrânire	îmbătrâni
îmblătire	îmblăti
îmbrăcare	îmbrăca
îmbucătățire	îmbucătăți
îmbuteliatoare	îmbuteliatoare
împădurire	împăduri
împărtășire	împărtăși
împerechere	împerechere
împlântare	împlânta
împoporare	împopora
împrejurare	împrejur
împrumut	împrumut
împuternicit	împuternici
înăbușire	înăbuși
înălțătură	înălțătură
încasare	încasa
încălcare	încălca
încăpere	încăpere
încântare	încânta
încetățenire	încetățeni
încheiere	încheiere
închipuire	închipui
înciudare	înciuda
încolăcire	încolăci
încontrare	încontra
încovoială	încovoială
încrețire	încreț
încuietoare	încuietoare
încurcat	încurca
îndeletnicire	îndeletnici
îndobitocire	îndobitoci
îndrăcire	îndrăci
îndrumare	îndrumar
înfăptuire	înfăptui
înfeudare	înfeuda
înfiolare	înfiola
înfrânare	înfrâna
înfundare	înfunda
îngăimeală	îngăimeală
îngeraș	îngeraș
înghiontire	înghionti
îngrămădire	îngrămădi
îngrijire	îngriji
îngurzitură	îngurzitură
înjugare	înjuga
înlesnire	înlesni
înmormântare	înmormânta
înnebunire	înnebuni
înnoptare	înnopta
înrăutățire	înrăutăți
însăilare	însăila
înscriere	înscrie
însetare	înseta
înspițare	înspița
însurățel	însurățel
întărâtare	întărâta
întemeiere	întemeiere
întinzător	întinzător
întortochere	întortochere
întrefier	întrei
întreținere	întreține
întrupare	întrupa
înțelenire	înțeleni
învălmășeală	învălmășeală
învățământ	învățământ
învârtitură	învârtitură
înverzire	înverzi
învinovățire	învinovăți
înzdrăvenire	înzdrăveni
jac	jac
jaf	jaf
jale_de_grădină	jale_de_grădină
jambieră	jambieră
japanolog	japanolog
japonism	japon
jardinieră	jardinieră
javart	javart
jăcaș	jăcaș
jecmăneală	jecmăneală
jelire	jeli
jerbă	jerbă
jetfoil	jetfoil
jiancă	jiancă
jieneasca	jieneasca
jigou	jigou
jimblărie	jimblărie
jipan	jip
jivină	jivină
joc	joc
joi	joi
joncțiune	joncțiune
jovialitate	jovial
jude	jude
judiciarist	judiciar
jugănel	jugăni
jujeu	jujeu
jumătate	jumătate
juncancă	juncancă
junețe	junețe
junincă	junincă
jupâneșică	jupâneșică
jur	jur
jurimetrie	jurimetrie
jurnalist	jurnal
justițiabil	justiția
kabili	kabili
kamala	kamala
karateka	karateka
kelvin	kelvin
keynesism	keynesism
kilobyte	kilobyte
kilolitru	kilolitru
kilovoltmetru	kilovolt
kirghiză	kirghiză
kovar	kovar
la	la
labiacee	labiacee
laborantă	laborantă
lac	lac
laconism	laconic
lactariu	lactar
lactoferment	lactoferment
lactoscop	lactoscop
laf	laf
laibăr	laibăr
lalea	leal
lambă	lambă
lamelare	lamelar
laminare	laminar
laminoristă	laminoristă
lampist	lampă
landă	landă
lanital	lanital
lanț	lanț
lapidaritate	lapidar
lapis	lapis
laptele-cucului	laptele-cucului
larice	larice
laringologie	laringolog
larvicid	lari
laș	laș
laticifer	laticifer
latinizare	latiniza
latorfian	latorfian
laureată	laureată
laviu	lavă
lazurit	laur
lăcătuire	lăcătui
lăcrimea	lăcrima
lăcușor	lăcătuș
lăicer	lăicer
lămbuitor	lămbui
lănțușor	lănțuș
lărgime	lărgime
lăsătură	lăsătură
lăstunaș	lăstunaș
lățire	lăți
lăutar	lăut
lână	lână
leafă	leafă
leaț	leaț
lectură	lectură
lefușoară	lefușoară
legământ	legământ
legătoreasă	legătoreasă
legislație	legislație
legiune	legiune
legumieră	legumieră
leiculiță	leiculiță
lelicuță	lelicuță
lemnărie	lemnărie
lene	lemn
lenjuri	lenaj
leorbău	leorbău
lepidolit	lepidolit
leprozerie	leprozerie
lesivaj	lesivaj
leșin	leș
letraset	letraset
leucism	leucă
leucometru	leucom
leucoterapie	leucoterapie
levantinism	levantin
levitație	levitație
lexicografă	lexicografă
lezare	leza
libanez	libanez
liber-profesionistă	liber-profesionistă
liberian	liber
libidinozitate	libidinozitate
licărit	licăr
lichefiere	lichefiere
lichidatoare	lichidatoare
licitator	licita
lider	lied
ligament	ligament
lignofoliu	lignofoliu
liliacee	liliac
limba-mielului	limba-mielului
limbă-de-mare	limbă-de-mare
limfangită	limfangită
limfopoieză	limfopoieză
limnigramă	limnigramă
limonit	limonie
linacee	linacee
lingotieră	lingotieră
linguriță	linguriță
liniarizare	liniariza
liniștire	liniști
linotipist	linotip
lintiță	lintiță
lipan	lip
lipidemie	lipidemie
lipoidă	lipoidă
lipsă	lipsă
liseză	liseză
literaritate	literar
litiază	litiază
litofit	litofag
litosferă	litosferă
litraj	litră
lude	lud
lizibilitate	lizibil
lobelie	lobelie
localizare	localiza
locativ	locantă
locotenent	locotenent
locuință	locuință
loden	loden
logiciană	logiciană
logofeteasă	logofeteasă
logonevroză	logonevroză
loialism	loial
lombardare	lombard
lonjeron	lonjeron
lornion	lori
lotizare	lotiza
lovitură	lovitură
lubricitate	lubric
luciditate	lucid
lucrătură	lucrătură
ludovic	ludovic
lugojeana	lugojeana
lumânărica-pământului	lumânărica-pământului
luminanțmetru	luminanțmetru
luminist	lumină
lumpen	lumpen
lunculiță	lunculiță
lungire	lung
lunulă	lunulă
lupinoză	lupinoză
luptător	luptă
lusitanian	lusitan
lustruitoare	lustruit
lutier	lut
luxfer	lux
macabe	macabe
macaragistă	macaragistă
macedonean	macedonean
macferlan	macferlan
machiavelist	machiavelic
maclare	maclare
macroclimat	macroclimă
macrofil	macrou
macromoleculă	macromoleculă
macroseism	macropsie
maculă	maculă
madrigal	madrigal
mag	mag
maghiară	maghiară
magistrat	magistru
magnaliu	magnalin
magnetobiologie	magnetobiologie
magnetomotor	magnetomotor
magnetotecă	magnetotecă
magniflex	magniflex
mahalagiță	mahalagiță
mahomedanism	mahomedan
maică	maică
maimuțărire	maimuțări
maizenă	maizenă
majoritate	major
malacologă	malacologă
malar	mal
malaxoristă	malaxoristă
malformație	malformație
malofagie	malofag
maltozurie	maltozurie
mamă	mamă
mamograf	mambo
mancipație	mancipație
mandat	mandat
mandolinată	mandolinată
manea	mană
manevrier	manevră
manganezit	manganezit
mango	mango
manichiureză	manichiureză
manifestant	manifest
manioc	manioc
manivelă	manivelă
mansup	mansup
mantică	mantică
manufactură	manufactură
maquisard	maquisard
marasm	marasm
marcă	marcă
marcocartofilie	marcocartofilie
mardeiaș	mardeiaș
mareșal	mare
marghioleală	marghioleală
margrafiat	margraf
marinărie	marinărie
marmită	marmită
maro	maro
marsupializare	marsupializa
martalog	marital
martiriu	martir
marți	marți
marxist-leninist	marxist-leninist
masă	masă
mascul	mas
masiv	mas
mast	mast
mastită	mastită
mașiculiu	mașiculiu
mașteră	mașteră
matelotaj	matelot
materialitate	material
matisare	matisa
mator	mat
matrițare	matrița
matuf	matuf
mațe-pestrițe	mațe-pestrițe
maxilă	maxilă
maximatecă	maximatecă
mazetă	mazetă
măcăitură	măcăitură
măceș	măceș
măcrișul-iepurelui	măcrișul-iepurelui
măgăriță	măgăriță
măicuță	măicuță
mălăier	mălăiaș
mămăligă	mămăligă
mămular	mămular
măngălău	măngălău
măr	măr
mărămuță	mărămuță
mărgărităraș	mărgărităraș
mărgineancă	mărgineancă
măritat	mărit
mărturisire	mărturisi
mărunțit	mărunți
măscărie	măscări
măsluire	măslui
măsurător	măsură
mătăsărie	mătăsărie
măturar	mătură
măturoi	măturoi
mâgliseală	mâgliseală
mânaș	mânaș
mâncăcios	mâncăcios
mândrețe	mândrețe
mânecar	mânecă
mânjitură	mânjitură
mânuță	mânuță
mânzuc	mânzuc
mârșăvire	mârșăvi
mâțuc	mâțuc
mecanică	mecanică
mecanoreceptor	mecanoreceptor
meconină	meconină
medelniță	medelniță
mediație	mediație
medico-sanitar	medico-sanitar
medievistică	medievistică
medius	medius
megabit	bit
megaevoluție	evoluție
megalocitoză	megalocitoză
megarelief	relief
megieș	megieș
mehedințean	mehedințean
mei-lung	mei-lung
mel	mel
melanism	melană
melasare	melasa
melenaș	melenaș
melismă	melismă
melod	melod
melodramatism	dramatic
melomanie	mani
melul-canarilor	melul-canarilor
memorator	memora
menadă	menadă
mendre	mendre
meningoencefalită	meningoencefalită
menstruație	menstruație
mentenanță	mentenanță
menzil	menzil
mercantilizare	mercantiliza
mercerizare	merceriza
meremetiseală	meremetiseală
merinos	mering
mersol	mers
mesaj	mers
meseriaș	meseriaș
mestecare	mestec
meșină	meșină
meșteșugire	meșteșug
metacronism	metacronism
metaforă	metaforă
metageometrie	geometric
metalin	lin
metalofon	metal
metalosferă	metalosferă
metamatematică	matematică
metanefridie	nefridie
metastazare	metastaza
meteahnă	meteahnă
meteoritică	meteoritică
meteorologist	meteorolog
meteosputnic	meteosputnic
metilmorfină	metilmorfină
metoc	metoc
metodologie	metodolog
metrician	metric
metropolă	metropolă
mezalianță	alianță
mezenter	mezenter
mezofită	mezofită
mezosferă	mezosferă
miambal	miambal
miazănoapte	miazănoapte
micetism	mischet
micologie	micolog
microagregat	agrega
microautomobil	automobil
microbiolog	bivol
microbuz	microbuz
microchirurgie	chirurg
micrococ	coc
microcoulomb	coulomb
microeconomie	econom
microfilmare	film
microfonistă	microfonistă
micrografie	graf
microinterviu	inter
micrometrie	micrometric
micron	mi
micropedagogie	pedagog
micropsie	micropsie
microrilă	microrilă
microsomi	microsomi
microtelefon	telex
microvolt	volt
micșunea	mișun
mielărea	mielărea
mielopatie	mielopatie
mieluță	mieluță
mierluță	mierluță
migălire	migăli
migrenă	migrenă
mijlocel	mijloc
mildiograf	milino
miliardar	miliard
milimicron	milimicron
militantism	militant
milițian	miliție
milogeală	milogeală
mimansa	mimansa
mimoză	mimoză
minciunică	minciunică
mineralog	mineral
miniaparat	miniaparat
miniautoturism	miniautoturism
minicasetofon	minicasetofon
minifustă	minifustă
minimagnetofon	minimagnetofon
minipotel	minipotel
miniteatru	minte
minorit	minor
minune	minune
minuțiozitate	minuțiozitate
miocrom	miocrom
miologie	miologic
miorar	mior
miotomie	miotomie
mirador	mira
mireasmă	mireasmă
mirmidon	mirmidon
miruire	mirui
miscibilitate	miscibil
misir	misir
misoginie	misogin
mistagogie	mistagog
mistificație	mistificație
mișină	mișină
mitacism	mitacism
miting	miting
mitografie	mitograf
mitralieră	mitralieră
mituire	mitui
mixedem	mixedem
mixtiune	mixt
mizerabil	mizer
mlăștiniș	mlăștiniș
moară	moară
mobil	morb
mobilometru	mobilometru
mocănime	mocănime
mocoșit	mocoși
modelară	modelară
modelistă	modelistă
moderare	moder
modificabilitate	modifica
modulare	modular
moftangioaică	moftangioaică
mohican	mohican
mojicie	mojic
molatic	mola
moldoveancă	moldoveancă
moleșire	moleși
molia-albinelor	molia-albinelor
molibdenit	molibden
molimă	molimă
molotru	moloh
moment	miom
monahie	monah
mondialist	mondial
monetar	mont
monilioză	monilioză
monoandrie	monoandrie
monoclat	monoclu
monocultură	cultură
monofobie	fob
monogenist	gen
monohibridism	monohibrid
monom	monom
mononucleoză	mononucleoză
monoproducție	producție
monosexualitate	sexual
monotelit	monotelit
monoxid	monoxid
montanism	montan
monteză	monteză
monumentalist	monumental
moralitate	moral
morărel	morări
mordacitate	mordacitate
morfinomană	morfinomană
morfografie	morfografie
morfonemie	morfonem
moria	moria
mormânt	mormânt
moroșan	moroșan
morteză	morteză
morun	morun
mosorare	mosor
moșierime	moșier
moșneancă	moșneancă
motan	moft
moto	moto
motociclist	motociclu
motodrom	motodrom
motoplanor	motoplanor
motoretist	motoretă
motricitate	motricitate
moțogană	moțogană
moviloi	moviloi
mozambican	mozambican
mucarnic	mucar
mucenică	mucenică
mucină	mucină
mucușor	mucușor
mugilid	mugilid
muhurdar	muhur
muierușă	muierușă
mulgară	mulgară
mult-puțin	mult-puțin
multimilionar	milion
multiplu	multiplu
mumbaiergiu	mumbaiergiu
muncitor	munci
municipalizare	municipaliza
muntenism	muntean
murdărie	murdări
muribund	muribund
mursă	mursă
musă	musă
muscă-verde	muscă-verde
muscinee	muscinee
muson	mus
mustimetru	mustire
mușamalizare	mușamaliza
muștarieră	muștarieră
mutacism	muta
mutelcă	mutelcă
mutualitate	mutual
muzeografă	muzeografă
muzicant	muzică
muzicologă	muzicologă
nabederniță	nabederniță
nadpis	nadpis
nagaică	nagaică
naingiu	naingiu
namibian	namibian
nanomel	mel
naramz	naramz
narcis	narcis
narcoman	narcoman
narcotraficant	narcotraficant
nartecă	nartecă
nașă	nașă
natrolit	natrolit
naturist	natur
naufragiator	naufragiat
nautism	nat
navigatoare	navigatoare
navomodelism	navomodel
nazificare	nazifica
năbușire	năbuși
năframă	năframă
năimit	năimi
nămol	nămol
năpârcă	năpârcă
nărăveală	nărăveală
năsălie	năsălie
năsilnicie	năsilnic
năsuț	năsuț
nătărău	nătărău
năvalnic	năvală
năvodire	năvod
neacceptare	accept
neajungere	ajunge
neaoșist	neaoș
nebăgate	nebăgat
nebunie	nebun
nechezare	nechez
necombatant	combate
necrobie	necrobie
necrolatrie	necrolatrie
necrotomie	necrotomie
necumpătare	cumpăt
nedesăvârșire	desăvârși
nefalism	nefalism
nefericire	feric
nefridie	nefridie
nefropat	nefropat
negativism	negativ
negel	gel
neglijență	neglijență
negresă	negresă
negrușcă	negrușcă
nehotărâre	hotărâre
neîndemânare	îndemâna
nelucrare	lucra
nemeș	nemeș
nemțean	nemție
nemurire	mur
neoartroză	artroză
neoclasicism	clasic
neofascism	flasc
neogramatic	gramatic
neolatin	lat
neologist	neolog
neonazist	naz
neoramă	ramă
neostalinist	salin
nepalez	nepalez
nepopularitate	popular
neprihănire	neprihănire
nerecunoscător	recunoscător
nervatură	nervatură
nesaț	saț
nesimțire	simț
nesupunere	supune
netezitoare	netezitoare
neurastenizare	neurasteniza
neurocibernetică	neurocibernetică
neurolimfă	neurolimfă
neuroplegic	neuroplegic
neutralism	neutral
nevăstuică	nevăstuică
nevolnic	volan
nevropat	nevropa
newtonian	newton
nichiperce	nichiperce
nicrom	nicrom
nictofobie	nictofobie
nihilist	nihilist
nimfomană	nimfomană
ninja	ninja
nisfia	nisfia
nistagmus	nistagmus
nitrificație	nitrificație
nitroglicerină	nitroglicerină
nituitură	nituitură
nivometru	nivometru
nobil	no
nodozitate	nodozitate
noiță	noiță
nomenclaturistă	nomenclaturistă
nonagenar	nonagenar
nonius	ius
nopticică	nopticică
nord-coreean	nord-coreean
noriță	noriță
normatoare	normat
noroi	noroi
nosologist	nosologic
notariat	notar
notistă	notistă
nouraș	nouraș
noveletă	noveletă
nuanță	nuanță
nuclearist	nuclear
nucșoară	nucșoară
nufăr	nufăr
nulitate	nul
numeral	nume
numismat	numismat
nuntaș	nuntaș
nurisă	nurisă
nutrire	nutri
nuvistor	nuvelist
obădar	obăda
oberec	oberec
obiectiv	obiect
obijduitor	obijdui
obliganță	obliganță
oblon	oblu
oboreană	oboreană
obrăznicătură	obrăznicătură
obscurizat	obscuriza
obsidian	obidi
obstrucționare	obstrucționa
obtuzitate	obtuz
ocazie	ocazie
occipital	occipital
oceanografie	oceanograf
ochelari	ochelari
ochii-păsăruicii	ochii-păsăruicii
ochlorație	ochlorație
ocnire	ocnire
ocopație	ocopație
octatlonistă	octatlonistă
octolet	ocol
oculist	ocult
ocupantă	ocupantă
odă	odă
odinofagie	odinofagie
odometru	odometru
odontografie	odontografie
odontoragie	odontoragie
odorob	odorob
oferire	feri
oficleid	oficleid
ofiolatrie	ofiolatrie
ofițeraș	ofițeraș
ofsetipie	ofsetipie
oftalmoplegie	oftalmoplegie
ogar	ogar
ogor	ogor
ohmmetru	ohmmetru
oinist	oină
olandez	olandez
ole	ole
oleofilizare	oleofilizare
olfactronică	olfactronică
oligoclaz	oligoclaz
oligopot	pot
oliță	liță
oloiniță	oloiniță
omag	mag
ombrofobie	ombrofobie
ometiță	ometiță
omletă	omletă
omofonie	fon
omologare	omolog
omotermie	termic
onanist	onanist
oncțiune	oncțiune
ondulor	ondula
onirist	onirist
onomanție	onomanție
onorabilitate	onora
ontologistă	ontologistă
op	op
opal	pal
operabilitate	opera
operaționalitate	operațional
opilație	opilație
opintire	opinti
opistotonus	opistotonus
oposum	oposum
opresare	presa
oprobriu	oprobriu
optică	optică
optocuplor	optocuplor
opus	pus
oraniță	raniță
oratorism	orator
orășean	orășel
orândă	orândă
orbie	orb
orchestrant	orchestră
orcic	orc
ordinogramă	ordinogramă
oreion	ovrei
orfelinat	orfelin
organicitate	organic
organogeneză	organogeneză
organum	organum
orhidacee	orhidacee
orientalist	oriental
origine	origine
ornament	orna
ornitofaună	ornitofaună
ornitomanție	ornitomanție
orografă	orografă
orotip	orotip
orticonoscop	orticonoscop
ortodontologie	ortodontologie
ortogeneză	geneză
ortologie	ortologie
ortopol	pol
ortoseismometru	seismometru
orzărie	orzărie
osândă	osândă
oscilograf	oscilă
oseină	seină
osmiridiu	osmiridiu
ospătat	ospăta
ospitalitate	ospitalitate
ostentație	ostentație
osteogeneză	osteogeneză
osteonecroză	osteonecroză
ostilitate	ostil
ostracoderm	ostracoderm
ostroveanca	ostroveanca
oștire	știr
otfel	otfel
otologă	otologă
otorinolaringologă	otorinolaringologă
otrățelul-bălților	otrățelul-bălților
oțel-balot	oțel-balot
oțiozitate	oțiozitate
ovalitate	oval
ovăzcior	ovăzcior
ovoscop	ovoscop
oxibioză	oxibioză
oxidimetru	oxidimetru
oxilit	xilit
ozenă	ozenă
ozonometru	ozonometru
pachebot	pachebot
pacificație	pacificație
padelă	padelă
paginație	paginație
pahar	pahar
pai	pai
paiol	pai
paladizare	paladizare
palatin	palat
palavră	palavră
paleoastronaut	astronaut
paleoclimă	climă
paleofitolog	fit
paleografie	graf
paleontologie	paleontolog
paleoteriu	paleoteriu
palicar	palici
palingeneză	palingeneză
palm	palm
palmă-cu-spini	palmă-cu-spini
paloare	pal
palpă	palpă
paludism	paludă
pamfletar	pamflet
panafricanism	african
panarabism	arab
pancivilizație	civilizație
pandajmetrie	pandajmetrie
pandit	panda
paneton	pane
pangermanistă	germanistă
panicul	panic
panmixie	panmixie
panpsihism	psi
panslav	slav
panteist	teist
pantofărie	pantofărie
pantonomie	pantonomie
panzer	zer
papagalism	papagal
paparună	paparună
papilă	papilă
papirologie	papirolog
papuaș	papuaș
papură-roșie	papură-roșie
parabioză	parabioză
parachinezie	parachinezie
paradaisă	paradaisă
paradosire	dos
parafă	fă
parafrazare	fraza
paragenetică	genetică
paraguayan	paraguayan
paralelism	paralel
paralizare	paraliza
parametron	parametru
paranoism	paranoia
parapod	pod
parasexualitate	sexual
parataxă	taxă
paratuberculoză	tuberculoză
paraziticid	parazit
parbriz	parbriz
parcelă	parcelă
parcurs	parcurs
paremiologă	paremiologă
parfum	parfum
parietal	paiet
pariu	par
parlamentar	parlament
parodiator	parodia
parodontopatie	parodontopatie
paronimie	paronim
paroxitonism	paroxiton
parte	part
parter	part
particulă	particulă
partizan	partizan
parvenit	parveni
pasarelă	pasarelă
pascal	pască
pasifloră	pasifloră
pasivitate	pasiv
pastel	pastă
pastișare	pastișa
pașcă	pașcă
patafizician	patafizic
patefon	parte
paternalism	paternal
patinatoare	patinat
patisieră	patisieră
patognomonie	patognomonic
patos	pat
patriciană	patriciană
patriotism	patriot
patronesă	patronesă
patruped	patru
pauză	pauză
pavecerniță	pavecerniță
pavoazare	pavoaz
pazvant	pazvant
păcălitură	păcălitură
păcurar	păcură
păduchele-calului	păduchele-calului
păduriță	păduriță
păhăraș	păhăraș
păienjeniș	păienjeniș
pălălaie	pălălaie
pălăvrăgeală	pălăvrăgeală
pălmiță	pălmiță
pământeancă	pământeancă
păpăradă	păpăradă
păpușică	păpușică
părăsitură	părăsitură
părinție	părinție
păsare	păs
păscătoare	păscătoare
păstorit	păstor
păstrugarniță	păstrugarniță
pășuneală	pășuneală
pătrățel	pătrățel
pătuiac	pătuiac
păun	păun
pâclă	pâclă
pâlnie	pâlnie
pângărire	pângări
pânzărie	pânzărie
pâră	pâră
pârâtură	pârâtură
pârguit	pârgui
pârlogire	pârlogi
pârtioară	pârtioară
pecarizare	pecariza
pecie	pecie
pectoza	pectoza
pedalizare	pedalizare
pederastie	pederast
pedichiurist	pedichiură
pediometru	pediometru
pedofobie	pedofobie
pedonosologie	pedonosologie
pegmatit	pegmatic
pejmă	pejmă
pelasg	pelasg
peliculă	peliculă
pelit	perl
pelticărie	pelticărie
pelvis	pelvis
penalizație	penalizație
pendularistă	pendularistă
penetrologie	penetrologie
peninsulă	peninsulă
pensă	pensă
pensulare	pensula
pentalogie	pentalogie
pentatlon	pentatlon
pentozurie	pentozurie
pepene	pepene
peponidă	peponidă
peptonurie	peptonurie
percepționalism	percepțional
percutare	cuta
perdeluță	perdeluță
perempțiune	perempțiune
perfecționare	perfecționa
perforator	perforat
pergamentar	pergament
periartrită	artrită
periclaz	periclaz
periculozitate	periculozitate
perieră	eră
perigeu	perigeu
perinefrită	nefrită
perioadă	perioadă
periodonțiu	periodonțiu
periplizon	periplizon
perisologie	perisologie
periteliu	periteliu
perjă	perjă
perlon	perl
permian	permis
permutație	mutație
peroneu	peron
perperit	perper
persană	persană
persiană	persiană
personalist	personal
perspectivitate	perspectiv
pertuizană	pertuizană
peruzea	peruzea
pervitină	pervitină
pescărime	pescărime
pesimism	pesimism
pestref	pestref
pește-cu-spadă	pește-cu-spadă
petardă	petardă
peticel	petic
petiționară	petiționară
petrel	per
petrogeneză	geneză
petrolistă	listă
pețiol	peți
pezevenghi	pezevenghi
pianoforte	pianoforte
piațetă	piațetă
pică	pică
pichire	pichire
picior	pici
picnisondă	picnisondă
picosecundă	picosecundă
pictogramă	pictogramă
picurătoare	picurătoare
piedin	piedin
pielită	pielită
piemontez	piemontez
pieptănătorie	pieptănător
pierdere	pierde
piesuță	piesuță
pietreancă	pietreancă
piezograf	piez
pigmee	pigmee
pilafgiu	pilaf
pilire	pil
piloroplastie	piloroplastie
pin	pin
ping-pong	ping-pong
pintaderă	pintaderă
pionefrită	pionefrită
pipăială	pipăială
piperment	piper
pipirig	pipirig
pirat	pir
pirheliograf	pirheliograf
pirofobie	pirofob
pirogravură	pirogravură
piromantă	piromantă
pirop	pirop
pirotehnică	pirotehnică
piruetă	piruetă
piscan	pisc
pisetă	pisetă
pisolit	pistol
pistolard	pistol
pistruială	pistruială
pișleag	pil
pitărcuță	pitărcuță
pitic	pită
pitting	pitting
pițigoi-codat	pițigoi-codat
piuitură	piuitură
pivotare	pivot
placaj	plac
placentă	placentă
plafonetă	plafonetă
plai	plai
planctologie	planctologie
planetoid	planetoid
planimetru	planimetru
planșă	planșă
plantator	plantat
plasare	plasa
plasmochină	plasmochină
plasticator	plastica
plastifiere	plastifiere
plastografiere	plastografie
platcă	platcă
platinoid	platinoid
plaur	plaur
plăcintărie	plăcintărie
plămădire	plămădi
plăpumărie	plăpumărie
plângere	plânge
plebe	plebe
plecate	plecate
plen	plen
pleonast	peon
plesiotip	plesiotip
pleșuvie	pleșuv
pleurezie	pleurezie
pleviță	pleviță
plictis	plictis
plinire	plin
pliscușor	pliscușor
plocon	poc
plointe	plointe
plonjeu	plonj
ploscar	ploscă
plug	plug
plumb	plumb
plumieră	plumieră
pluripartitism	pluripartit
pluș	pluș
plutit	plută
plutonier	pluton
pluviograf	pluvios
pneumatologie	pneumatologie
pneumolog	pneumolog
pneumoterapie	pneumoterapie
poama-câinelui	poama-câinelui
poantă	poantă
pocal	poc
pocânzeu	pocânzeu
pocitură	pocitură
pocnitură	pocnitură
podbeal	podbeal
podire	pod
podoabă	podoabă
podotehnică	podotehnică
poet	poet
poetizare	poetiza
pogace	pogace
pogonofor	pogonofor
poichilotermie	poichiloterm
pojghiță	pojghiță
polarizare	polariza
polcovnic	polcovnic
poleitor	poleit
polen	polen
poliandră	poliandră
polichet	polichet
polidimensionalitate	polidimensional
polifagie	polifag
poligeneză	geneză
poligraf	graf
polimer	mer
polinom	polei
poliploidie	poliploid
polisemie	polisemic
polisportiv	sport
politeism	teism
politician	politic
politonalitate	tonal
polițist	țist
polizat	poliza
pologar	polog
poltron	poltron
pomadă	pomadă
pomeți	pomeți
pomolog	podmol
pompierie	pompier
ponderare	pondera
ponofobie	ponofobie
pontatoare	pontat
pontonier	ponton
popândoc	popândoc
poplin	pol
popotar	popotă
populație	populație
porcan	porc
porfir	porfir
pornitor	porni
portabilitate	port
portavoce	portavoce
portcart	portcart
portfard	port
portmoneu	portmoneu
portpagină	portpagină
portschi	portschi
portunealtă	portunealtă
porumbar	porumb
porunceală	porunceală
posibilism	posibil
pospolită	pospolită
postav	postav
postdatare	dat
posteucă	posteucă
postpoziție	poziție
postulantă	postulantă
poșadă	poșadă
poștăriță	poștăriță
potamolog	potamofil
potcă	potcă
potentat	potent
potică	potică
potnog	pot
potrivă	potrivă
poturi	pot
povârnire	povârni
povod	povod
poziționer	poziționa
practiciană	practiciană
pragmatism	pragmatic
prasem	prasem
pravoslavnic	pravoslavnic
prăbușitură	prăbușitură
prăfuire	prăfui
prăjitor	prăjit
prăsadă	prăsadă
prăștină	prăștină
prânzare	prânz
preadolescent	preadolescent
preanestezie	anestezic
precambrian	cambre
preceptistă	preceptistă
precipițiu	precipițiu
precombustie	combustie
precorector	corect
precuvântare	cuvânt
predeterminant	determina
predicație	predicație
predominație	dominație
prefabricat	fabrică
prefector	prefect
prefiltru	filă
preformism	preformism
preindexare	preindexare
preînregistrare	înregistra
prelată	lată
preluare	lua
premarxist	marxist
premieră	premieră
premontaj	mont
prenumerant	prenume
preoție	preoți
prepelicar	prepelicar
preprocesor	proces
prerogativă	prerogativă
presă	presă
prescură	prescură
preserie	ser
presiometru	presiometru
presortare	sort
prestidigitație	prestidigitație
presurizator	presurizat
pretcă	pretcă
pretextare	pretext
prețăluire	prețălui
prevaricator	prevarica
prevestit	prevesti
prezbit	prezbit
prezentare	prezent
prezicător	prezicător
prezumțiozitate	prezumțiozitate
priceasnă	priceasnă
pricolici	pericol
prigonitoare	prigonitoare
prim-pretor	prim-pretor
primatolog	primat
primejdie	primejdie
primitivitate	primitiv
principe	principe
prințesă	prințesă
pripeală	pripeală
prislop	prislop
prispuliță	prispuliță
prișniț	prișniț
privată	privată
priveliște	priveliște
prizometru	prizometru
proband	proband
probitate	prob
probozire	probozi
procentaj	procent
prochestor	ches
proconsul	con
proctectazie	proctectazie
procurator	curat
prodigiozitate	prodigiozitate
productometru	productometru
profascist	flasc
profesionist	profesional
profetism	profet
profit	fit
profundor	profund
proglotă	glotă
program	gram
progresist	progres
prohodire	prohod
proiecție	proiecție
prolemă	lemă
prolixitate	prolix
promilă	milă
promovabilitate	promova
pronație	pronație
propagandist	propagandă
propedeutică	propedeutică
propilitizare	propilitizare
propoziție	poziție
proptire	propti
prorocie	proroc
proscris	scris
prosopel	prosop
prospectologie	prospectologie
prostatită	prostatită
prostituare	prostitua
protamină	protamină
proteidă	proteidă
proterozoic	proterozoic
protipendadă	protipendadă
protocarbură	carbură
protoierie	protoierie
protoplast	potop
protoromână	română
protuberanță	protuberanță
proveditor	proveditor
provincial	provincie
provizoriu	provizorat
prozaizare	prozaiza
prozodist	prozodem
prujă	prujă
pruncucigaș	pruncucigaș
prundărie	prundărie
pruniș	pruniș
psalmist	psalm
psamom	psamom
pseudocilindru	cilindru
pseudodipter	dipter
pseudoliterată	literată
pseudopatriot	pater
pseudosufix	sufix
psihastenică	psihastenică
psihobiologie	biolog
psihofizician	fizic
psiholingvist	lingav
psihonevroză	nevroză
psihosexologie	sexolog
psihotonic	ton
psofometru	psofometru
ptialină	ptialină
publican	public
puchițel	puchi
pudlaj	pudel
puerilitate	pueril
pufnire	pufni
pugilistică	pugilistică
puicuță	puicuță
pulberărie	pulberărie
pulpare	pulpar
pulsație	pulsație
pulverulență	pulverulență
punci	punci
punctualism	punctual
pungășeală	pungășeală
puntișoară	puntișoară
pupejoară	pupejoară
puponieră	puponieră
purces	pur
puricat	purice
purificație	purificație
purjor	purjă
purulență	purulență
pustnică	pustnică
pușcăriaș	pușcăriaș
pușlama	pușlama
putinar	putină
putregăire	putregăi
putritudine	putritudine
quasar	quasar
rabană	rabană
rabinat	rabin
rabotat	rabota
rachetist	rachetă
raclaj	raclă
racul-pământului	racul-pământului
radianță	radianță
radicalizare	radicaliza
radină	radină
radioascultare	asculta
radiobiologă	biologă
radiocompas	compas
radioecou	ecou
radioficare	radiofica
radiogalaxie	galaxie
radiogramă	radiogramă
radiolog	radio
radiomicrofon	micro
radioprogram	program
radioscopie	radio
radiostereografie	stereograf
radiotelegramă	telegramă
radioterapie	terapie
radom	radom
rafinament	rafina
raganelă	raganelă
rahis	rahis
raionare	raion
ram	ram
ramcă	ramcă
ramoliție	ramoliție
randomizare	randomiza
rantie	rantie
rapid	rapid
rapsodiere	rapsodie
rariță	rariță
rasoleală	rasoleală
rașel	rașel
ratieră	ratieră
rațiocinație	rațiocinație
ravagiu	ravagiu
razmot	razmot
răbuială	răbuială
răchitiș	răchitiș
răcoreală	răcoreală
rădăcină-dulce	rădăcină-dulce
răgălie	răgălie
rămurea	rămuri
răpire	răpi
răritură	răritură
răsăriteancă	răsăriteancă
răsculare	răscula
răsfrângere	răsfrânge
răspundere	răspunde
răstocire	răstoci
răsucitură	răsucitură
răsură	răsură
rășinoase	rășinoase
rățoiaș	rățoiaș
răvășire	răvăși
război	război
răzbunică	răzbunică
răzlețire	răzleț
răzuș	răzuș
râcâitură	râcâitură
râmnic	râmă
rând	rând
rânjeală	rânjeală
râsul-pădurii	râsul-pădurii
rât	rât
rea-voință	rea-voință
reactiv	act
reacumulare	acumula
reajustare	ajusta
realitate	real
reanclanșare	anclanșa
reargintare	argintar
rebegeală	rebegeală
rebus	bus
recalificare	califica
recelare	recela
recepare	recepare
recepționist	recepționa
rechiziționare	rechiziționa
recipiendară	recipiendară
recitatoare	recitatoare
reclasificare	clasifica
recomandație	recomandație
recompunere	compune
reconstituire	constitui
reconvocare	convoca
recreator	crea
recrutor	recrut
rector	rect
reculegere	culege
recurgere	curge
recviem	recviem
redempțiune	redempțiune
redibiție	redibiție
redistribuție	distribuție
reducător	reducător
reduplicație	duplicație
reeșalonare	eșalon
refecare	refec
referențialitate	referențial
reflectivitate	reflectivitate
reflexivitate	reflexiv
reformare	formar
refractometru	refractometru
refringență	refringență
refuzare	refuz
regăsire	găsi
regenerescență	regenerescență
regina-peștilor	regina-peștilor
registru	registru
reglement	reglet
regresiune	regres
regulație	regulație
reinfectare	infect
reinterpretare	interpret
reînălțare	înălța
reînființare	înființa
reîntâlnire	întâlni
rejeton	jet
relativitate	relativ
relectură	lectură
relicvariu	relicvariu
relonistă	relonistă
remanență	remanență
remilitarizare	militariza
remizier	remiză
remorcare	remorca
renaștere	naște
renină	renină
rentier	renet
reograf	rebo
reorganizare	organiza
reoxidare	oxid
repasare	pas
repelent	repelent
repetenție	repetenție
repezitură	repezitură
repliu	pliu
repovestire	povesti
reprezentativitate	reprezentativ
reproducător	product
reptilă	reptilă
reputație	reputație
resignație	resignație
respir	respir
restabilire	stabil
restitutoare	restitutoare
resurecție	resurecție
reșițeancă	reșițeancă
retăbăcire	tăbăci
reticul	retiv
retorician	retoric
retragere	trage
retribuție	retribuție
retrocompatibilitate	compatibil
retroreflector	reflect
rețea	rețea
reunificare	unifica
revalorizare	valoriza
revelator	revela
revent	revent
revers	vers
revitalizare	vitaliza
revocabilitate	revoca
revolver	revolver
rezemare	rezema
rezidență	rezidență
rezinat	rezina
rezistor	rezista
rezonator	rezona
ribonuclează	ribonuclează
ricoșeu	ricoșa
ridiche	ridiche
rigiditate	rigid
rihtuit	rihtui
rindea	rid
rinologă	rinologă
ripidă	ripidă
risorgimento	risorgimento
ritmogramă	ritmogramă
rițuit	rițui
rizacă	rizacă
rizogen	rizom
röntgendiagnostic	röntgendiagnostic
robie	rob
robotit	robot
rochie	rochie
rodanță	rodanță
rodnicie	rodnic
rodozahar	rodozahar
rohatcă	rohatcă
rolan	rol
romancieră	romancieră
romașcan	romașcan
românist	român
romeu	rom
ronjant	ronja
rosbif	rosbif
rostru	rost
roșioară	roșioară
rotametru	rotare
rotăreasă	rotăreasă
rotiserie	rotiserie
rotogravură	rotogravură
rotoțele-albe	rotoțele-albe
rouă	rouă
roza-vânturilor	roza-vânturilor
roznoveancă	roznoveancă
rubelit	ruber
rubinspinel	rubinspinel
rudă	rudă
ruf	ruf
rugăciune	rugăciune
rugozimetru	rugozimetru
rujar	ruj
rulaj	rula
rumân	rumân
rumeneală	rumeneală
runologă	runologă
ruptor	rupt
ruscuță	ruscuță
rusofobie	rusofob
rușinare	rușina
rutenism	rutean
ruxandră	ruxandră
sablant	sable
sabotaj	sabot
sacagiu	sac
sacoșă	sacoșă
sacrificiu	sacrifica
sadină	sadină
safran	safir
sagna-calului	sagna-calului
saidecar	saidecar
salahorit	salahor
salată-creață	salată-creață
salcâm	salcâm
salicilină	salicilină
salipirină	salipirină
salmoneloză	salmoneloză
salopetă	salopetă
saltație	saltație
salutație	salutație
salvă	salvă
samavolnicie	samavolnic
sampan	sampan
sanctitate	sanctitate
sandră	sandră
sanidinit	sanidină
sanscritist	sanscrit
santonină	santonină
saponificație	saponificație
sarafan	sarafan
sarcofag	sarcom
sard	sard
sare	sard
sarmațian	sarma
sat	sat
satin	sat
satiseală	satiseală
saț	saț
savantism	savant
saxaul	saxaul
săbărelul	săbărelul
săculteț	săculteț
săgetar	săgeta
sălăjean	sălăjean
sălbăticiune	sălbăticiune
sămăluire	sămăluire
sănișoară	sănișoară
săpie	săpie
săpunel	săpun
sărăcan	sărăci
sărătură	sărătură
sărit	săra
săsoaică	săsoaică
săturare	sătura
sân	sân
sângerat	sânger
sârb	sârb
sârmuliță	sârmuliță
scadență	scadență
scaiete	scaiete
scalogramă	scalogramă
scanare	scana
scap	scap
scara-pisicii	scara-pisicii
scarp	scarp
scădere	scădere
scăldătoare	scăldătoare
scăricică	scăricică
scărpinat	scărpina
scâlciere	scâlciere
scândurice	scândurică
scârboșenie	scârboșenie
scârțâitură	scârțâitură
scenă	scenă
sceptic	sept
schelălăitură	schelălăitură
scherzo	scherzo
schiatron	schiatron
schilodenie	schilod
schimnică	schimnică
schingiuit	schingiui
schituleț	schituleț
schizoidie	schizoid
scientizare	scientiza
scintilație	scintilație
scizionist	sciziona
sclavie	sclav
scleron	scleră
sclipeț	sclipeț
scobai	scobai
scofâlcitură	scofâlcitură
scoliotic	scoliotic
scopire	scop
scordolea	scordolea
scoroambă	scoroambă
scorțăraș	scorțăraș
scotocire	scotoci
scrânteală	scrânteală
scrib	scrib
scrijelire	scrijeli
scripte	scripte
scrisa	scrisa
scrofularia	scrofularia
scrumbiță	scrumbiță
scud	scud
scuipătoare	scuipătoare
sculișor	sculișor
scumpie	scump
scurtcircuitare	scurtcircuit
scuter	scut
scuzare	scuza
seboree	seboree
secătură	secătură
seceriș	seceriș
sechestrație	sechestrație
sectant	sectă
secționator	secționa
secundariat	secundar
securizator	securiza
sedimentator	sedimenta
sefard	seif
seignettoelectricitate	seignettoelectricitate
seismogramă	seismogramă
seișă	seișă
selectron	selector
selecțiuni	selecțiuni
selenologă	selenologă
sem	sem
semanticism	semantic
semănătură	semănătură
semiasiatic	asiat
semicivilizație	civilizație
semiconsonantă	semiconsonantă
semifin	fin
semigrup	grup
semimetal	meat
semințenie	semințenie
semiotică	semiotică
semiproletar	proclet
semitism	semit
semizeu	zeu
semnatară	semnatară
senat	sen
seninețe	seninețe
sensitogramă	sensitogramă
senzaționalism	senzațional
separare	separa
septembrie	septembrie
septuagenar	septuagenar
serai	serai
serdărie	serdărie
serializare	serializa
sericitizare	sericitizare
seriozitate	seriozitate
serotin	serotin
serpetă	serpetă
servant	serv
servitoare	servit
servoreglare	servoreglare
setaveraj	setaveraj
sevas	sevas
sexolog	o
sextuor	sextuor
sfacel	sac
sfănțoaică	sfănțoaică
sfătoșenie	sfătoșenie
sfârâit	sfârâi
sfârloagă	sfârloagă
sfenoid	sfenoid
sfertișor	sfertișor
sfetnic	sfen
sfigmotensiometru	sfigmotensiometru
sfințișor	sfinți
sforar	sfor
sfrâncioc	sfrâncioc
sfumato	sfumato
sialografie	sialografie
sibilant	sibilă
sichiraș	sichiraș
sicriu	sicar
siderostat	siderostat
sifilidă	sifilidă
sifonar	sifon
sigilion	sigiliu
signatară	signatară
sihăstrire	sihăstri
silcă	silcă
silf	silf
silice	siglic
silicoză	silicoză
silmanal	silan
silozar	siloz
silvanit	silvan
silvologie	silvologic
simbioză	simbioză
simbrie	brei
simfonie	fon
similidiamant	similidiamant
simpatic	simpatic
simpatologie	patolog
simplon	simplu
simțire	simț
simultaneitate	simultaneitate
sinanterale	sinanterale
sinăian	seină
sinclitism	silit
sincrofazotron	sincrofazotron
sincronogamie	sincronogamie
sindicalizare	sindicaliza
sinectică	sinectică
sinergism	sinergic
singeneză	geneză
singulativ	singulativ
sinodalitate	sinodal
sinonimie	sinonim
sinovită	vită
sinterizare	sinteriza
sinuozitate	sinuozitate
sipică	sipică
sirinx	sirinx
sistare	sista
sistru	sistru
sitișcă	sitișcă
situație	situație
sladniță	sladniță
slavism	slav
slavon	slav
slăninuță	slăninuță
slobozenie	slobozenie
slorcătoare	slorcătoare
slugărie	slugări
sluguță	sluguță
slujitor	sluji
sluțire	sluți
smălțuitor	smălțui
smeci	smeci
smiorcăială	smiorcăială
smochinet	smochin
smotocire	smotoci
snobism	snob
soare	soare
sobor	snob
social-democrație	social-democrație
socinian	socinian
sociolect	sociolect
sociometrie	sociometric
socotit	socoti
sodomie	sodom
sofistă	sofistă
soharici	soharici
solarigraf	solariu
soldare	dar
soleide	soleide
solicitare	solicita
solidificare	solidifica
solist	ist
solodiu	odiu
solutrean	solutrean
solz	solz
somatofiziogramă	somatofiziogramă
sombrero	sombrero
somnie	somn
somnuleț	somnuleț
sonată	sonată
sonetist	sonet
sonosferă	sonosferă
sorab	sorab
sorbită	sorbită
soredie	soredie
sorocean	soroc
sortilegiu	sorti
sosit	sos
soțior	scoți
sovpren	sovpren
spalax	spalax
spaniolă	spaniolă
spart	spart
spat	spat
spațiere	spațiere
spălător	spălător
spătărel	spătărel
specialitate	special
spectacol	spectacol
spectroheliograf	spectroheliograf
speculare	specular
speluncă	speluncă
speriat	speria
spermatocit	spermatocit
spermocultură	spermocultură
spic	spic
spiculă	spiculă
spinalgie	spinal
spining	spining
spinul-cerbului	spinul-cerbului
spirant	spiră
spiritizare	spiritizare
spiromat	spiromat
spițelnic	spițelnic
splenectomie	splenectomie
spoitoare	spoit
spolocanie	spolocanie
spongiozitate	spongiozitate
sporange	sporange
sporozoar	sporozoar
sprânceană	sprânceană
sprinter	sprint
spumegare	spumega
spusă	spusă
stabilitate	sta
stadă	stadă
stafidă	stafidă
stagnoplancton	stagnoplancton
stamatian	stamatian
stanat	stan
staniță	staniță
startbloc	startbloc
stathuder	stathuder
stative	stativ
statu-quo	statu-quo
stațiograf	staționa
stavrid	stavrid
stăpânire	stăpân
stăvilar	stăvili
stâlpușor	stâlpușor
stânjenel	stânjen
stârv	stârv
steatonecroză	steatonecroză
stegocefal	stegocefal
stelaj	stel
steluță	steluță
stenografă	stenografă
stenotipist	stenotip
stepizare	stepizare
stereocomparator	stereocomparator
stereogramă	stereogramă
stereoscopie	stereoscop
stereotipist	stereotip
stern	stern
sticlar	sticlă
sticluță	sticluță
stihoavnă	stihoavnă
stilist	stil
stilograf	stilou
stimulator	stimula
stins	stins
stipulare	stipular
stivă	stivă
stocher	stoc
stoler	stol
stomac	stomac
stop	stop
stornare	storna
strachină	strachină
strangulare	strangula
strateg	strateg
stratometru	strabotomie
străchinea	străchinar
străfund	străfund
străluc	străluc
strănepot	strănepot
strâmbare	strâmb
strângător	strângător
strecurătoare	strecurătoare
stresor	stres
strictură	strictură
strigă	strigă
strigoime	strigoime
striu	star
strofism	strofă
strop	strop
stropșitură	stropșitură
strugure	strugure
strung	strung
strunire	struni
student	sud
stufărie	stufărie
stupefacție	stupefacție
stupizenie	stupizenie
styroflex	styroflex
subapreciere	apreciere
subchiriaș	chiriaș
subconștient	conștient
subdomeniu	dolmen
subfamilie	familie
subiectivare	subiectiv
subînchiriere	închiriere
sublimare	sublim
subluxație	luxație
submultiplu	multiplu
subprefectură	prefectură
subregn	regn
subsecretariat	secretar
subsolaj	subsol
substanțialitate	substanțial
substrucție	substrucție
subtext	text
subunitate	uni
subzonă	zonă
succesoare	succes
sucit	suc
sud-american	sud-american
sudanez	sudanez
suduitură	suduitură
sufist	stuf
suflare	sufla
suflu	suflu
suge-bute	suge-bute
sughițare	sughiț
suide	suide
sul	sul
sulfatiazol	sulfatiazol
sulfocarbonism	sulfocarbonism
sulicioară	sulicioară
sultanat	sultan
suman	sumă
sumănel	sumă
sunat	suna
sunnită	sunnită
supercalculator	calculat
supergalaxie	galaxie
superorticon	ortic
supertehnologie	tehnolog
supinator	suspinat
suplică	suplică
suporter	suport
supraclasă	clasă
supradozaj	doză
suprafață	față
supraînălțare	înălța
supramaturație	maturație
supraponderabilitate	pondera
suprarafinare	rafina
supraspecie	specie
supraveghere	veghe
supremație	supremație
supușime	supușime
surchideală	surchideală
surdomutitate	surdomut
surguci	surguci
surmenare	surmena
sursă	sursă
survivanță	survivanță
susan	sus
suspect	suspect
sustentație	sustentație
sutaș	sutaș
suveicuță	suveicuță
șa	șa
șabracă	șabracă
șahist	șah
șalanger	șalanger
șalutier	șalutier
șambrană	șambrană
șan	ș
șansonetist	șansonetă
șantan	șan
șapirograf	șapirograf
șaretă	șaretă
șarm	șarm
ceasla	ceasla
șătrăreasă	șătrăreasă
școlar	școli
ședințomanie	ședințoman
șelărie	șelărie
șeniletă	șeniletă
șerb	șerb
șerpar	șerpar
șerpuire	șerpui
șesime	șes
șevretă	șevretă
șfichiuire	șfichiui
șif	șif
șinar	șină
cincilă	cincilă
șipsandler	șipsandler
șirețel	șirețel
șiș	șiș
șlagăr	șlagăr
șlefuitor	șlefuit
șluf	șluf
șmuțtitlu	șmuțtitlu
șnuruleț	șnuruleț
șobolan	șobolan
șofrănaș	șofrănaș
șoimușor	șoimușor
șomaj	șoim
șopăire	șopăi
șopteală	șopteală
șorici	șort
șoseluire	șoselui
șovar	șovar
șpais	șpais
șperlă	șperlă
șplint	șplint
șpul	șpul
ștafetă	ștafetă
ștanțator	ștanța
ștempar	șteamp
ștergătoare	ștergătoare
ștevie	ștevie
știoalnă	știoalnă
știucă	știucă
ștrecuire	ștrecui
șubeică	șubeică
șuetă	șuetă
șuierătoare	șuierătoare
șuncă	șuncă
șustă	șustă
șușuială	șușuială
șuvoi	șuvoi
tabacoză	tabacoză
tabinet	tain
taboriți	taboriți
tabulație	tabulație
tachinare	tachina
tacticiană	tacticiană
tafta	tafta
tahimetrie	tahimetric
tahilalică	tahilalică
tahografie	tahograf
taifun	taifun
talamus	talamus
talasografie	talasografie
talâm	talâm
talger	tal
talmudism	talmudic
talpa-stăncii	talpa-stăncii
tamar	taim
tambură	tambură
tanana	tanana
tanchist	tanc
tangență	tangență
tanti	tanti
taoistă	taoistă
tapioca	tapioca
tapotare	tapota
taraf	taraf
tarapangele	tarapangele
tarhan	tar
taroc	taroc
tarsoclast	taroc
tartină	tartină
tasă	tasă
tasterist	taster
tată	tată
taurină	taurină
tautonim	tautonim
taxație	taxație
taxi-furgonet	taxi-furgonet
taxocenologie	taxocenologie
taxonomist	taxonomic
tăbănaș	tăbănaș
tăciune	tăciune
tăiculiță	tăiculiță
tăifăsuială	tăifăsuială
tălhărășug	tălhărășug
tălpiță	tălpiță
tămâiere	tămâier
tămbălău	tămbălău
tărânc	tărânc
tăricioare	tăricioare
tătarcă	tătarcă
tătâne	tătâne
tău	tău
tăvălugire	tăvălug
tâlhărie	tâlhări
tâmplă	tâmplă
tânjală	tânjală
târboc	târboc
târgovișteancă	târgovișteancă
târn	târn
târnuit	târnui
târșitoare	târșitoare
teandrie	teandrie
teatrolog	teatrolog
tec	tec
tectonică	tectonică
tehnică	tehnică
tehnocrație	tehnocrație
tehnoredactor	tehnoredacta
teism	teism
telalgie	telal
teleautografie	autograf
telecinemateca	telecinemateca
telecopiator	copiat
teledirijare	dirija
teleficare	teleficare
telefonogramă	fonogramă
teleghidare	ghid
teleguță	teleguță
telelea	telelea
telemăsură	măsură
teleobiectiv	obiect
telepatie	telepat
telerecording	recording
telescaun	scaun
telesport	sport
teletop	top
telexist	telex
tembelism	tembel
temnicioară	temnicioară
tempo	tempo
tencuială	tencuială
tender	tendă
teniază	teniază
tenosinovită	tenosinovită
tentacul	tenta
teodolit	teodolit
teoremă	teoremă
teraforming	teraforming
terasier	teras
terciuială	terciuială
terfelog	terfeli
terifite	terifite
terme	terme
termoficare	termofica
terminus	terminus
termoanalgezie	termoanalgezie
termochimie	termochimie
termocromie	termocromic
termoenergetică	termoenergetică
termogen	termos
termologie	termologie
termoplastic	termoplast
termoscop	termoscop
termotelefon	termotelefon
terorist	teroare
terțarolare	terțarola
tescuire	tescui
testatoare	testatoare
testosteron	testosteron
tetă	tetă
tetracord	cord
tetrahidrobenzen	tetrahidrobenzen
tetrarhat	tetrarh
teugă	teugă
textilist	textil
textualitate	textual
thailandez	thailandez
ticăit	taică
tifan	timf
tiflopedagogie	tiflopedagogie
tighel	tighel
tihnă	tihnă
timar	taim
timișean	timie
timonier	timonă
timpanotomie	timpanotomie
tinerețe	tinerețe
tiocarbamidă	tiocarbamidă
tipărire	tipări
tipo	tipo
tipsie	tipsie
tiraspolean	tiraspolean
tiriplic	tiriplic
tirșcaș	tirșcaș
titlu	titlu
titularizare	titulariza
tizană	tizană
toarcere	toarce
toc	toc
tocăniță	tocăniță
tocire	toc
tocsin	toc
tolă	tolă
toloșcan	toloșcan
tomată	tomată
tomograf	tom
tonă-registru	tonă-registru
tonificare	tonifica
tonsură	tonsură
topic	top
topitorie	topitor
topografă	topografă
toponimist	toponim
toptangiu	toptan
torcret	torr
tornadă	tornadă
torpilor	torpilă
torșon	tor
toscan	trosc
tovarăș	tovarăș
toxicodermie	toxicodermie
toxofobie	toxofobie
tracolog	trac
tractus	tractus
trafă	trafă
tragediană	tragediană
traheomicoză	traheomicoză
traină	traină
tramvai	tramvai
trandafiruț	trandafiruț
transcendentalism	transcendental
transcriitor	transcriitor
transfigurație	figurație
transformist	transforma
transgresiune	transgresiune
translatoare	translatoare
transmisie	misie
transoceanic	ocean
transplantologie	transplantologie
transsiberian	siberian
tranșator	tranșa
tranzitare	tranzitar
trapezărie	trapezărie
trasare	tras
tratat	tarat
traumatologă	traumatologă
travertin	travertin
trăgătoare	trăgătoare
trăncăneală	trăncăneală
trăsurică	trăsurică
trânji	trânji
treacăt	treacăt
trecere	trece
trei-păzește	trei-păzește
trematod	trematod
tremurat	tremur
trencicot	trencicot
trepădat	treapăd
tresă	tresă
tretin	tretin
trialism	trial
tribadă	tribadă
tribrah	tribrah
trichiază	trichiază
tricofiție	tricofiție
tricotat	tricot
tridimensionalitate	tridimensional
trifoiște	trifoiște
trigonocefal	trigon
trilogie	trilogie
trincă	trincă
trinitroglicerină	nitroglicerină
trioxid	oxid
triplet	tripal
tripodie	tripod
trireactor	rect
tristih	stih
triton	ton
triumvirat	triumvir
troacă	troacă
trofie	trofic
trohoidă	trohoidă
trombectomie	trombectomie
trombonist	trombon
trompetaș	trompetaș
tronișor	tronișor
tropism	trop
trosnet	trosni
truc	truc
trufă	trufă
trupă	trupă
truver	truver
tuberculos	tubercul
tucan	truc
tufecciu	tufecciu
tulbureală	tulbureală
tulnic	tul
tumbelechi	tumbelechi
tunar	tun
tuniscop	tuniscop
turan	tur
turbelariat	turbelariat
turbionare	turbionar
turboinjector	turboinjector
turbotren	turbotren
turcoaică	turcoaică
turelă	turelă
turiță	turiță
turn	turn
turnichet	turnichet
turtă	turtă
tuset	tuns
tușieră	tușieră
tutoare	tutoare
tutuire	tutu
tuțorism	tuțorism
țanc	țanc
țar	țar
țarină	țarină
țăncușă	țăncușă
țărănie	țărănie
țărmureancă	țărmureancă
țânțar	țâț
țârâita	țârâita
țâșnitură	țâșnitură
țâțână	țâțână
țepoșică	țepoșică
țest	țest
țiclău	țiclău
țigară	țigară
țigănime	țigănime
țiitoare	țiitoare
țingău	țingău
ținutaș	ținutaș
țistuială	țistuială
țoabă	țoabă
țoliță	țoliță
țopișoară	țopișoară
țuică	țuică
țundriță	țundriță
țuțui	țuț
ucenic	ucenic
ucraineană	ucraineană
udometru	udometru
uimire	uimi
ulan	ulan
ulcus	ulcus
ulm	ulm
ultracondensator	condensat
ultragiere	ultragiere
ultramodernism	modern
ultrasonogramă	ultrasonogramă
uluire	ului
umblare	umbla
umbrelar	umbrelă
umeraș	umeraș
umilință	umilință
unanimitate	unanim
undă	undă
uneltitor	unelti
unghiulație	unghiulație
ungurime	ungur
uniformitate	uniform
unisonanță	unisonanță
universalitate	universal
untișor	untișor
urangutan	urangutan
uranolatrie	uranolatrie
urător	ură
urbanitate	urban
urcuș	urcuș
urecheală	urecheală
ureter	urlet
urgie	urgie
urlat	urla
urmaș	urmaș
urmuță	urmuță
urogastronă	urogastronă
urs-de-mare	urs-de-mare
ursoaică	ursoaică
uruguayan	uruguayan
urzit	urzi
uscăturea	uscătură
usturoi	usturoi
ușor	uș
utilaj	util
utopist	utopist
uvrieră	uvrieră
uzinaj	uzină
uzurpatoare	uzurpatoare
vaccin	vaccin
vacs	vacs
vadră	vadră
vaginism	vagin
vagonet	vagon
valabilizare	valabiliza
valgus	valgus
valonee	valon
valuator	valuator
vameș	vameș
vandrug	vandrug
vapor	vapor
var	var
varia	varia
varicelă	varicelă
varistență	varistență
varvă	varvă
vasel	vas
vasopresină	vasopresină
vatman	vatman
văcărit	văcări
vădrar	văr
văicăreală	văicăreală
vălătuceală	vălătuceală
vălțuitor	vălțui
văpăiere	văpăi
vărsământ	vărsământ
văscior	văscior
vătămător	vătămător
vătuie	vătui
vâjâitură	vâjâitură
vâlvă	vâlvă
vânătorime	vânător
vântrea	vânt
vânturătură	vânturătură
vârcolac	vârcolac
vârșă	vârșă
vâslă	vâslă
vechie	vechi
vector	veac
vedriță	vedriță
vehicul	vechi
velă	velă
velist	velă
velodrom	velodrom
venalitate	venal
venerologă	venerologă
venghercă	venghercă
ventilare	ventil
ventru	venă
verant	verb
verbigerație	verbigerație
veresie	veresie
veridicitate	veridic
veriguță	veriguță
vermicul	veric
vermut	vermut
vers	vers
verslibrist	verslibrism
verticală	verticală
vervă	vervă
vesperă	vesperă
vestiment	vesti
veterană	veterană
vetustate	vetustate
vezică	vezică
vibrafonist	vibrafon
vibrolaminare	vibrolaminare
vicecampioană	vicecampioană
vicepreședinte	vicepreședintă
vicleșug	vicleșug
vidanjare	vidanja
videodiscotecă	videodiscotecă
vidicon	veridic
viereasă	viereasă
viermuire	viermui
viespoi	viespoi
viforniță	viforniță
viitorime	viitor
vilanelă	vilanelă
vin	vin
vinci	vinci
vindiac	vindiac
vingalac	vingalac
vinil	vin
vintir	vintir
violabilitate	viola
violetă	violetă
viorică	viorică
vir	vir
virgație	virgație
virolă	virolă
virulicid	virulicid
visceroptoză	visceroptoză
vistavoi	vistavoi
vișinică	vișinică
vitamină	vitamină
viteză	viteză
vitraj	vir
vitriolaj	vitriol
vițică	vițică
vivianit	vivianit
vizibilimetru	vizibilimetru
vizirat	vizir
vizualizare	vizualiza
voaior	voi
vocală	vocală
vociferare	vocifera
voiajor	voiaj
voinicie	voinic
volant	viol
volet	viol
volocel	voloc
voltijă	voltijă
volumetru	volum
vomare	voma
vopsit	vopsi
vorbit	vorbă
vorniciță	vorniciță
votrie	votri
vraiște	vraiște
vrăciță	vrăciță
vrânceancă	vrânceancă
vrescurel	vrescurel
vuit	vu
vulcanologie	vulcanolog
vulnerare	vulnerar
vultan	vultan
vută	vută
warant	warant
webermetru	weber
wofatit	wofatit
xantelasmă	xantelasmă
xantopsie	xantopsie
xenogeneză	xenogeneză
xerobole	xerobole
xerograf	xerox
xilidină	xilidină
xilogravură	xilogravură
xografie	xografie
yiang-yiang	yiang-yiang
yterbiu	yterbit
zaceală	zaceală
zaharicale	zaharicale
zaharoză	zaharoză
zaiflâc	zaiflâc
zambilică	zambilică
zapateado	zapateado
zaraf	zaraf
zarvă	zarvă
zavergiu	zavergiu
zăbovire	zăbovi
zăcășie	zăcășie
zăgaș	zăgaș
zălăuan	zăblău
zăluzeală	zăluzeală
zănoagă	zănoagă
zăpor	zăpor
zăticneală	zăticneală
zăvoi	zăvoi
zimbru	zimbru
zbânțuială	zbânțuială
zbârcitură	zbârcitură
zbenguire	zbengui
zbornic	zbor
zburătuire	zburătui
zdrăngănire	zdrăngăni
zdrobitură	zdrobitură
zebră	zebră
zefir	zefir
zeină	zeină
zemoșire	zemoși
zeppelin	zeppelin
zetetic	zetetic
zevzecie	zevzec
zgâlțâit	zgâlțâi
zgârie-brânză	zgârie-brânză
zgrăbunță	zgrăbunță
zguduire	zgudui
ziaristă	ziaristă
zidar	zid
zigomă	zigomă
zimază	zimază
zimț	zimț
zincografiere	zincografie
zlac	zlac
zmeu	zmeu
zoaie	zoaie
zoizit	zoizit
zonită	zonită
zoocultură	zoocultură
zoograf	zoo
zoologă	zoologă
zoon	zoon
zooplastie	zooplastie
zootehniciană	zootehniciană
zorcan	zor
zorzon	zor
zulum	zulum
zurbavă	zurbavă
zvâcnit	zvâcni
zvârlitură	zvârlitură